id,user,id,followers_count,indegree,outdegree,Degree,eigencentrality,modularity_class,weighted indegree,weighted outdegree,Weighted Degree,Eccentricity,closnesscentrality,harmonicclosnesscentrality,betweenesscentrality,pageranks,modularity,color
1,@interactionorg,1,32449,5,6,11,0.220081,31,31,22,53,2,0.666667,0.75,607.5,0.026321,Greater than 30,#FF7575
2,@worldbank,2,2830344,420,7,427,1,31,1244,94,1338,2,0.888889,0.9375,4365.369048,0.121184,Greater than 30,#FF7575
3,@kgeorgieva,3,,18,0,18,0.264785,31,56,0,56,0,0,0,0,0.03271,Greater than 30,#FF7575
4,@ifc_org,4,136992,87,3,90,0.389581,0,299,21,320,2,0.615385,0.6875,525.297619,0.037877,0 - 4,#FF75FF
5,@jeffthindwa,5,1416,0,1,1,0,31,0,2,2,3,0.5,0.537037,0,0.000446,Greater than 30,#FF7575
6,@nancyvr13,6,120,0,1,1,0,0,0,1,1,4,0.37931,0.431818,0,0.000446,0 - 4,#FF75FF
7,@petepizarro,7,54578,57,3,60,0.093212,0,57,134,191,3,0.555556,0.633333,484,0.018065,0 - 4,#FF75FF
8,@cghuerta967,8,112,0,1,1,0,0,0,1,1,4,0.37931,0.431818,0,0.000446,0 - 4,#FF75FF
9,@yakamalu,9,188,0,1,1,0,0,0,1,1,4,0.37931,0.431818,0,0.000446,0 - 4,#FF75FF
10,@analu_granda,10,491,1,5,6,0.001635,0,1,14,15,3,0.458333,0.560606,7,0.000636,0 - 4,#FF75FF
11,@edgebuildings,11,20829,3,1,4,0.005549,0,8,2,10,3,0.409091,0.462963,3,0.000745,0 - 4,#FF75FF
12,@cguzman365,12,1040,0,1,1,0,0,0,1,1,4,0.37931,0.431818,0,0.000446,0 - 4,#FF75FF
13,@rscribeiro,13,166,0,1,1,0,0,0,1,1,3,0.409091,0.462963,0,0.000446,0 - 4,#FF75FF
14,@educacionpub,14,2387,0,2,2,0,0,0,2,2,4,0.392857,0.477273,0,0.000446,0 - 4,#FF75FF
15,@ilumno,15,,11,0,11,0.036325,0,28,0,28,0,0,0,0,0.007358,0 - 4,#FF75FF
16,@freddyrrr,16,256,0,1,1,0,0,0,1,1,4,0.37931,0.431818,0,0.000446,0 - 4,#FF75FF
17,@mario_yanis,17,196,0,1,1,0,0,0,1,1,4,0.37931,0.431818,0,0.000446,0 - 4,#FF75FF
18,@lhanekroot,18,199,0,9,9,0,1,0,16,16,3,0.548387,0.686275,0,0.000446,0 - 4,#FF75FF
19,@vbdo,19,2157,1,9,10,0.001635,1,1,128,129,3,0.551724,0.697917,1,0.000488,0 - 4,#FF75FF
20,@natcapcoalition,20,6033,4,0,4,0.007185,1,81,0,81,0,0,0,0,0.000534,0 - 4,#FF75FF
21,@rudyverstappen,21,,2,0,2,0.003592,1,9,0,9,0,0,0,0,0.000534,0 - 4,#FF75FF
22,@thegef,22,35124,4,1,5,0.006863,1,11,1,12,3,0.5,0.537037,14,0.00095,0 - 4,#FF75FF
23,@iucnnl,23,,2,0,2,0.003592,1,9,0,9,0,0,0,0,0.000534,0 - 4,#FF75FF
24,@iucn,24,,2,0,2,0.003592,1,9,0,9,0,0,0,0,0.000534,0 - 4,#FF75FF
25,@wwf,25,,2,0,2,0.003592,1,9,0,9,0,0,0,0,0.000534,0 - 4,#FF75FF
26,@wnfnederland,26,,1,0,1,0.001957,1,8,0,8,0,0,0,0,0.000492,0 - 4,#FF75FF
27,@vwidge,27,902,0,1,1,0,0,0,1,1,3,0.409091,0.462963,0,0.000446,0 - 4,#FF75FF
28,@jenniferartley,28,195,1,2,3,0.001635,0,1,6,7,3,0.434783,0.516667,0,0.000573,0 - 4,#FF75FF
29,@financecolombia,29,487,2,0,2,0.003592,0,5,0,5,0,0,0,0,0.000817,0 - 4,#FF75FF
30,@gpsa_org,30,1984,0,1,1,0,31,0,2,2,3,0.5,0.537037,0,0.000446,Greater than 30,#FF7575
31,@eliandrada27,31,211,0,2,2,0,0,0,2,2,4,0.392857,0.477273,0,0.000446,0 - 4,#FF75FF
32,@chavivohra,32,696,0,3,3,0,31,0,4,4,3,0.529412,0.592593,0,0.000446,Greater than 30,#FF7575
33,@oxfamifis,33,780,2,8,10,0.007,0,2,14,16,3,0.571429,0.638889,33.083333,0.001005,0 - 4,#FF75FF
34,@saubryhr,34,2422,17,5,22,0.040631,0,27,146,173,3,0.545455,0.597222,69.107143,0.002026,0 - 4,#FF75FF
35,@eachrights,35,740,22,17,39,0.060063,0,203,263,466,3,0.727273,0.826389,435.214286,0.002963,0 - 4,#FF75FF
36,@caooffice,36,,15,0,15,0.04248,0,67,0,67,0,0,0,0,0.002174,0 - 4,#FF75FF
37,@impactglocal,37,476,0,2,2,0,31,0,2,2,3,0.529412,0.592593,0,0.000446,Greater than 30,#FF7575
38,@sdg2030,38,18067,0,4,4,0,31,0,4,4,3,0.555556,0.633333,0,0.000446,Greater than 30,#FF7575
39,@watusicaycedo1,39,784,0,1,1,0,0,0,1,1,4,0.37931,0.431818,0,0.000446,0 - 4,#FF75FF
40,@evrahim_adamu,40,112,0,1,1,0,31,0,2,2,3,0.5,0.537037,0,0.000446,Greater than 30,#FF7575
41,@li_luchy,41,754,0,1,1,0,0,0,1,1,4,0.37931,0.431818,0,0.000446,0 - 4,#FF75FF
42,@melindarooke,42,15765,0,2,2,0,31,0,2,2,3,0.529412,0.592593,0,0.000446,Greater than 30,#FF7575
43,@cronicatvcomar,43,2578,0,3,3,0,0,0,3,3,3,0.55,0.621212,0,0.000446,0 - 4,#FF75FF
44,@fillonafrique,44,4094,0,2,2,0,31,0,2,2,3,0.529412,0.592593,0,0.000446,Greater than 30,#FF7575
45,@fer_eco,45,397,0,2,2,0,3,0,2,2,3,0.405797,0.446429,0,0.000446,0 - 4,#FF75FF
46,@jrrangel23,46,93,4,9,13,0.008514,3,4,58,62,3,0.54,0.635802,87,0.001203,0 - 4,#FF75FF
47,@_alide_,47,2440,2,4,6,0.005592,3,13,6,19,4,0.402985,0.484568,5.5,0.000602,0 - 4,#FF75FF
48,@arynaim,48,,1,0,1,0.003101,3,9,0,9,0,0,0,0,0.00056,0 - 4,#FF75FF
49,@bancomext,49,,3,0,3,0.008083,3,14,0,14,0,0,0,0,0.00073,0 - 4,#FF75FF
50,@nafinoficial,50,,2,0,2,0.005592,3,13,0,13,0,0,0,0,0.000602,0 - 4,#FF75FF
51,@le44avecfillon,51,2618,0,2,2,0,31,0,2,2,3,0.529412,0.592593,0,0.000446,Greater than 30,#FF7575
52,@paulino_marca,52,481,0,2,2,0,0,0,2,2,4,0.392857,0.477273,0,0.000446,0 - 4,#FF75FF
53,@nachotapatio,53,730,0,1,1,0,0,0,1,1,4,0.37931,0.431818,0,0.000446,0 - 4,#FF75FF
54,@franklinmolano,54,455,0,1,1,0,0,0,1,1,4,0.37931,0.431818,0,0.000446,0 - 4,#FF75FF
55,@lynncote,55,535,0,2,2,0,0,0,2,2,3,0.434783,0.516667,0,0.000446,0 - 4,#FF75FF
56,@simforsyth,56,745,1,2,3,0.001635,0,1,2,3,3,0.409091,0.462963,0,0.000636,0 - 4,#FF75FF
57,@wbg_dev4peace,57,12916,3,11,14,0.005746,31,3,49,52,3,0.68,0.784314,46,0.001089,Greater than 30,#FF7575
58,@huguesmoussy,58,43,0,5,5,0,0,0,5,5,3,0.492958,0.542857,0,0.000446,0 - 4,#FF75FF
59,@acafricacenter,59,2889,3,8,11,0.005324,2,3,104,107,3,0.551724,0.697917,4,0.000565,0 - 4,#FF75FF
60,@tahiradosani,60,,3,0,3,0.006326,2,15,0,15,0,0,0,0,0.000626,0 - 4,#FF75FF
61,@accionvlab,61,,3,0,3,0.006326,2,15,0,15,0,0,0,0,0.000626,0 - 4,#FF75FF
62,@chijioked,62,,3,0,3,0.006326,2,15,0,15,0,0,0,0,0.000626,0 - 4,#FF75FF
63,@onefico,63,,3,0,3,0.006326,2,15,0,15,0,0,0,0,0.000626,0 - 4,#FF75FF
64,@njidekaharry,64,,1,0,1,0.002638,2,13,0,13,0,0,0,0,0.000506,0 - 4,#FF75FF
65,@youthfortech,65,,2,0,2,0.004273,2,14,0,14,0,0,0,0,0.000554,0 - 4,#FF75FF
66,@aubreyhruby,66,3608,1,6,7,0.002638,2,13,6,19,3,0.516129,0.635417,0,0.000506,0 - 4,#FF75FF
67,@tete_sala,67,25,0,3,3,0,0,0,3,3,3,0.55,0.621212,0,0.000446,0 - 4,#FF75FF
68,@omnilincbiz,68,94,0,1,1,0,31,0,2,2,3,0.5,0.537037,0,0.000446,Greater than 30,#FF7575
69,@virginiaba,69,106,0,1,1,0,0,0,1,1,4,0.37931,0.431818,0,0.000446,0 - 4,#FF75FF
70,@martajuarezl,70,140,0,1,1,0,0,0,1,1,4,0.37931,0.431818,0,0.000446,0 - 4,#FF75FF
71,@robb1egz,71,328,0,3,3,0,0,0,3,3,3,0.55,0.621212,0,0.000446,0 - 4,#FF75FF
72,@modis_feed,72,1174,0,2,2,0,31,0,2,2,3,0.529412,0.592593,0,0.000446,Greater than 30,#FF7575
73,@marsolaries1,73,291,2,2,4,0.004982,3,55,2,57,3,0.409091,0.450617,10.5,0.000616,0 - 4,#FF75FF
74,@bivamx,74,,1,0,1,0.003101,3,5,0,5,0,0,0,0,0.00056,0 - 4,#FF75FF
75,@grupofinvel,75,,1,0,1,0.003101,3,5,0,5,0,0,0,0,0.00056,0 - 4,#FF75FF
76,@ankitsi66798650,76,93,0,1,1,0,31,0,2,2,3,0.5,0.537037,0,0.000446,Greater than 30,#FF7575
77,@dhelmonteler,77,46,0,1,1,0,0,0,1,1,4,0.37037,0.425,0,0.000446,0 - 4,#FF75FF
78,@lieselpritzker,78,2039,1,2,3,0.001635,0,1,2,3,3,0.529412,0.592593,9,0.000827,0 - 4,#FF75FF
79,@tungalagdondog,79,647,0,4,4,0,0,0,4,4,3,0.480769,0.54,0,0.000446,0 - 4,#FF75FF
80,@pochonavaro,80,3409,0,1,1,0,31,0,2,2,3,0.5,0.537037,0,0.000446,Greater than 30,#FF7575
81,@prissmacsltg,81,87,0,2,2,0,3,0,2,2,4,0.35,0.401786,0,0.000446,0 - 4,#FF75FF
82,@ifc_lac,82,8436,3,6,9,0.007227,3,7,12,19,3,0.442623,0.518519,30,0.000792,0 - 4,#FF75FF
83,@amundi_eng,83,3894,1,1,2,0.002813,3,2,1,3,3,0.5,0.537037,1.666667,0.000559,0 - 4,#FF75FF
84,@mexico2_pmc,84,,2,0,2,0.005304,3,6,0,6,0,0,0,0,0.000601,0 - 4,#FF75FF
85,@bmvmercados,85,,2,0,2,0.005304,3,6,0,6,0,0,0,0,0.000601,0 - 4,#FF75FF
86,@lumpurtiles,86,128,0,4,4,0,0,0,4,4,3,0.571429,0.652778,0,0.000446,0 - 4,#FF75FF
87,@victorernestov8,87,,1,0,1,0.001635,0,1,0,1,0,0,0,0,0.000541,0 - 4,#FF75FF
88,@toya_arq,88,50,0,1,1,0,0,0,1,1,4,0.37931,0.431818,0,0.000446,0 - 4,#FF75FF
89,@gonzarami1,89,5,0,6,6,0,0,0,6,6,3,0.518519,0.654762,0,0.000446,0 - 4,#FF75FF
90,@presidenteues21,90,,1,0,1,0.001635,0,1,0,1,0,0,0,0,0.000509,0 - 4,#FF75FF
91,@rectorasiglo21,91,,1,0,1,0.001635,0,1,0,1,0,0,0,0,0.000509,0 - 4,#FF75FF
92,@lasiglo21,92,,1,0,1,0.001635,0,1,0,1,0,0,0,0,0.000509,0 - 4,#FF75FF
93,@ejidatarioreba1,93,3974,0,1,1,0,0,0,1,1,4,0.37931,0.431818,0,0.000446,0 - 4,#FF75FF
94,@profegaby1961,94,136,0,1,1,0,0,0,1,1,4,0.37931,0.431818,0,0.000446,0 - 4,#FF75FF
95,@nadiadaar,95,427,0,4,4,0,0,0,5,5,3,0.471698,0.52,0,0.000446,0 - 4,#FF75FF
96,@kmaloufbous,96,520,7,2,9,0.026433,0,20,12,32,3,0.461538,0.5,17.345238,0.001479,0 - 4,#FF75FF
97,@maurineifernand,97,53,0,3,3,0,0,0,4,4,3,0.458333,0.560606,0,0.000446,0 - 4,#FF75FF
98,@washingtonlife,98,25071,1,2,3,0.001635,0,1,8,9,3,0.434783,0.516667,0,0.000573,0 - 4,#FF75FF
99,@hbsclubdc,99,,2,0,2,0.003592,0,5,0,5,0,0,0,0,0.000817,0 - 4,#FF75FF
100,@mariannevantag2,100,766,0,1,1,0,0,0,1,1,4,0.37931,0.431818,0,0.000446,0 - 4,#FF75FF
101,@salima_sn,101,1881,0,4,4,0,0,0,4,4,3,0.480769,0.54,0,0.000446,0 - 4,#FF75FF
102,@vcoyne,102,1024,0,3,3,0,0,0,3,3,3,0.458333,0.560606,0,0.000446,0 - 4,#FF75FF
103,@aramirezant,103,9,0,2,2,0,3,0,2,2,3,0.405797,0.446429,0,0.000446,0 - 4,#FF75FF
104,@capitannacho1,104,1850,0,2,2,0,0,0,2,2,4,0.392857,0.477273,0,0.000446,0 - 4,#FF75FF
105,@rfangulo,105,234,0,1,1,0,0,0,1,1,4,0.37931,0.431818,0,0.000446,0 - 4,#FF75FF
106,@quiara2016,106,73,0,1,1,0,0,0,1,1,4,0.37931,0.431818,0,0.000446,0 - 4,#FF75FF
107,@vccircle,107,43664,0,2,2,0,0,0,2,2,3,0.434783,0.516667,0,0.000446,0 - 4,#FF75FF
108,@cmautomation,108,,1,0,1,0.001635,0,1,0,1,0,0,0,0,0.000636,0 - 4,#FF75FF
109,@meriemgray,109,112,0,1,1,0,31,0,2,2,3,0.5,0.537037,0,0.000446,Greater than 30,#FF7575
110,@leocede2,110,1632,0,1,1,0,0,0,1,1,4,0.37931,0.431818,0,0.000446,0 - 4,#FF75FF
111,@halconesfin,111,250,2,14,16,0.005592,3,2,104,106,3,0.5625,0.709877,54,0.000688,0 - 4,#FF75FF
112,@ubuntuconvos,112,434,0,4,4,0,0,0,4,4,3,0.480769,0.54,0,0.000446,0 - 4,#FF75FF
113,@chikeziea1,113,284,0,4,4,0,0,0,4,4,3,0.480769,0.54,0,0.000446,0 - 4,#FF75FF
114,@investabank,114,,2,0,2,0.004982,3,5,0,5,0,0,0,0,0.000616,0 - 4,#FF75FF
115,@bancodesarrollo,115,,1,0,1,0.002491,3,4,0,4,0,0,0,0,0.000488,0 - 4,#FF75FF
116,@bcoestado_aldia,116,,1,0,1,0.002491,3,4,0,4,0,0,0,0,0.000488,0 - 4,#FF75FF
117,@el_bid,117,,1,0,1,0.002491,3,4,0,4,0,0,0,0,0.000488,0 - 4,#FF75FF
118,@fira_mexico,118,,1,0,1,0.002491,3,4,0,4,0,0,0,0,0.000488,0 - 4,#FF75FF
119,@asocbancosmx,119,,1,0,1,0.002491,3,4,0,4,0,0,0,0,0.000488,0 - 4,#FF75FF
120,@ifc_eap,120,2563,1,2,3,0.001635,0,1,8,9,3,0.434783,0.516667,1,0.000636,0 - 4,#FF75FF
121,@dfat,121,,1,0,1,0.001957,0,4,0,4,0,0,0,0,0.000717,0 - 4,#FF75FF
122,@moisesamilkar,122,1015,0,1,1,0,0,0,1,1,4,0.37931,0.431818,0,0.000446,0 - 4,#FF75FF
123,@ifc_southasia,123,2854,2,5,7,0.003657,0,2,22,24,3,0.6,0.694444,10,0.000823,0 - 4,#FF75FF
124,@m_alemayehu,124,205,1,2,3,0.002314,0,5,2,7,3,0.444444,0.513889,0,0.000586,0 - 4,#FF75FF
125,@shyamalmajumdar,125,,1,0,1,0.002314,0,5,0,5,0,0,0,0,0.000586,0 - 4,#FF75FF
126,@bsindia,126,,1,0,1,0.002314,0,5,0,5,0,0,0,0,0.000586,0 - 4,#FF75FF
127,@alienbtc,127,6409,0,2,2,0,4,0,2,2,1,1,1,0,0.000446,0 - 4,#FF75FF
128,@invoxfinance,128,,1,0,1,0.001635,4,1,0,1,0,0,0,0,0.000636,0 - 4,#FF75FF
129,@datacloudasia,129,1164,1,0,1,0.001635,4,1,0,1,0,0,0,0,0.000636,0 - 4,#FF75FF
130,@houseofshamuel,130,1300,0,2,2,0,31,0,2,2,3,0.529412,0.592593,0,0.000446,Greater than 30,#FF7575
131,@infodili,131,1389,0,3,3,0,0,0,3,3,3,0.458333,0.560606,0,0.000446,0 - 4,#FF75FF
132,@kompascom,132,,1,0,1,0.001635,0,1,0,1,0,0,0,0,0.000573,0 - 4,#FF75FF
133,@bankmandiri,133,,1,0,1,0.001635,0,1,0,1,0,0,0,0,0.000573,0 - 4,#FF75FF
134,@drgregoryjames,134,409,0,2,2,0,0,0,2,2,3,0.434783,0.516667,0,0.000446,0 - 4,#FF75FF
135,@fredahiabor,135,,1,0,1,0.001635,0,1,0,1,0,0,0,0,0.000636,0 - 4,#FF75FF
136,@matyht2005,136,201,0,1,1,0,0,0,1,1,4,0.37931,0.431818,0,0.000446,0 - 4,#FF75FF
137,@carlosa99405340,137,70,0,1,1,0,0,0,1,1,4,0.37931,0.431818,0,0.000446,0 - 4,#FF75FF
138,@vickykane55,138,180,0,1,1,0,0,0,1,1,4,0.37931,0.431818,0,0.000446,0 - 4,#FF75FF
139,@tancb29,139,315,0,3,3,0,0,0,4,4,3,0.470588,0.541667,0,0.000446,0 - 4,#FF75FF
140,@jingdonghua,140,279,1,3,4,0.001635,0,1,6,7,3,0.458333,0.560606,2,0.000573,0 - 4,#FF75FF
141,@gs10kwomen,141,,1,0,1,0.001957,0,2,0,2,0,0,0,0,0.000609,0 - 4,#FF75FF
142,@cck_keenan,142,,1,0,1,0.001957,0,2,0,2,0,0,0,0,0.000609,0 - 4,#FF75FF
143,@daveswords,143,1371,2,5,7,0.009789,31,11,5,16,3,0.492754,0.544118,190.75,0.00066,Greater than 30,#FF7575
144,@feisalhussain,144,195,0,4,4,0,0,0,4,4,3,0.48,0.597222,0,0.000446,0 - 4,#FF75FF
145,@the_lhoft,145,2957,2,3,5,0.003271,0,2,24,26,3,0.458333,0.560606,0,0.000636,0 - 4,#FF75FF
146,@crediteasecorp,146,,3,0,3,0.005549,0,10,0,10,0,0,0,0,0.000817,0 - 4,#FF75FF
147,@stanfordgsb,147,,3,0,3,0.005549,0,10,0,10,0,0,0,0,0.000817,0 - 4,#FF75FF
148,@indianvca,148,1223,0,1,1,0,0,0,1,1,3,0.409091,0.462963,0,0.000446,0 - 4,#FF75FF
149,@sandeep32806231,149,675,0,2,2,0,31,0,2,2,3,0.529412,0.592593,0,0.000446,Greater than 30,#FF7575
150,@felippehomero,150,328,0,2,2,0,0,0,2,2,3,0.44,0.515152,0,0.000446,0 - 4,#FF75FF
151,@thenergynet,151,23457,7,16,23,0.011991,5,7,138,145,3,0.727273,0.826389,144,0.00257, 5 - 9,FALSE
152,@seforallorg,152,,1,0,1,0.003933,5,14,0,14,0,0,0,0,0.000583, 5 - 9,FALSE
153,@wbg_energy,153,54802,4,2,6,0.009382,5,17,2,19,3,0.526316,0.583333,18,0.001183, 5 - 9,FALSE
154,@un,154,,4,0,4,0.010769,5,12,0,12,0,0,0,0,0.001666, 5 - 9,FALSE
155,@wef,155,,3,0,3,0.007558,5,11,0,11,0,0,0,0,0.000644, 5 - 9,FALSE
156,@wrienergy,156,,2,0,2,0.005568,5,7,0,7,0,0,0,0,0.00071, 5 - 9,FALSE
157,@viralaboutgreen,157,2055,0,1,1,0,5,0,1,1,4,0.431034,0.463333,0,0.000446, 5 - 9,FALSE
158,@msb_blue,158,426,0,1,1,0,5,0,1,1,4,0.431034,0.463333,0,0.000446, 5 - 9,FALSE
159,@esivla86,159,108,0,4,4,0,0,0,4,4,3,0.48,0.597222,0,0.000446,0 - 4,#FF75FF
160,@kirillklip,160,4738,0,1,1,0,5,0,1,1,4,0.431034,0.463333,0,0.000446, 5 - 9,FALSE
161,@stevecook58,161,273,0,1,1,0,5,0,1,1,4,0.431034,0.463333,0,0.000446, 5 - 9,FALSE
162,@anna_marriott,162,616,0,4,4,0,0,0,4,4,3,0.480769,0.54,0,0.000446,0 - 4,#FF75FF
163,@possotv,163,679,0,1,1,0,0,0,1,1,4,0.37931,0.431818,0,0.000446,0 - 4,#FF75FF
164,@franciscoarias7,164,393,0,1,1,0,0,0,1,1,4,0.37931,0.431818,0,0.000446,0 - 4,#FF75FF
165,@2amigosma,165,4725,0,2,2,0,0,0,2,2,3,0.44,0.515152,0,0.000446,0 - 4,#FF75FF
166,@energialpgc,166,234,0,1,1,0,5,0,1,1,4,0.431034,0.463333,0,0.000446, 5 - 9,FALSE
167,@rosss02250903,167,1711,0,1,1,0,0,0,1,1,4,0.37931,0.431818,0,0.000446,0 - 4,#FF75FF
168,@frederickshine,168,26,0,4,4,0,31,0,4,4,2,0.642857,0.722222,0,0.000446,Greater than 30,#FF7575
169,@tok_sili,169,41,0,1,1,0,0,0,1,1,3,0.409091,0.462963,0,0.000446,0 - 4,#FF75FF
170,@bridgeintlacads,170,5532,4,2,6,0.017371,31,17,2,19,3,0.529412,0.592593,0.666667,0.000809,Greater than 30,#FF7575
171,@giescr,171,,4,0,4,0.017165,0,14,0,14,0,0,0,0,0.00073,0 - 4,#FF75FF
172,@results_tweets,172,,4,0,4,0.017165,0,14,0,14,0,0,0,0,0.00073,0 - 4,#FF75FF
173,@sfrenchgiescr,173,,3,0,3,0.01553,0,13,0,13,0,0,0,0,0.000687,0 - 4,#FF75FF
174,@amb_a_mohammed,174,,2,0,2,0.013573,0,12,0,12,0,0,0,0,0.000641,0 - 4,#FF75FF
175,@hakijamiitrust,175,3071,1,11,12,0.0108,0,11,20,31,4,0.510638,0.649306,0,0.000595,0 - 4,#FF75FF
176,@tikenya,176,,2,0,2,0.013573,0,12,0,12,0,0,0,0,0.000641,0 - 4,#FF75FF
177,@thekhrc,177,,2,0,2,0.013573,0,12,0,12,0,0,0,0,0.000641,0 - 4,#FF75FF
178,@hakiknchr,178,,2,0,2,0.013573,0,12,0,12,0,0,0,0,0.000641,0 - 4,#FF75FF
179,@aphrc,179,,1,0,1,0.0108,0,11,0,11,0,0,0,0,0.000595,0 - 4,#FF75FF
180,@prkstntr,180,132,0,3,3,0,0,0,3,3,3,0.55,0.621212,0,0.000446,0 - 4,#FF75FF
181,@maggieliviah,181,225,0,3,3,0,0,0,3,3,3,0.471698,0.52,0,0.000446,0 - 4,#FF75FF
182,@ede_wbg,182,1797,2,3,5,0.003271,31,2,9,11,3,0.55,0.621212,4,0.000827,Greater than 30,#FF7575
183,@mmazumdar2014,183,907,0,4,4,0,11,0,12,12,3,0.571429,0.652778,0,0.000446,10 - 14,#75FFF7
184,@cnnnews18,184,3932179,50,3,53,0.084339,11,80,228,308,3,0.55,0.621212,134,0.006574,10 - 14,#75FFF7
185,@narendramodi,185,,40,0,40,0.082391,11,124,0,124,0,0,0,0,0.00672,10 - 14,#75FFF7
186,@bhupendrachaube,186,,25,0,25,0.059792,11,120,0,120,0,0,0,0,0.005255,10 - 14,#75FFF7
187,@nashatccc36,187,25,0,1,1,0,31,0,1,1,3,0.5,0.537037,0,0.000446,Greater than 30,#FF7575
188,@asthanavineeta,188,599,0,2,2,0,11,0,2,2,4,0.387097,0.465278,0,0.000446,10 - 14,#75FFF7
189,@alcidespaezsoto,189,2319,0,2,2,0,0,0,2,2,4,0.392857,0.477273,0,0.000446,0 - 4,#FF75FF
190,@chibuezeijeoma,190,10,0,1,1,0,31,0,1,1,3,0.5,0.537037,0,0.000446,Greater than 30,#FF7575
191,@stefanomanservi,191,3753,2,2,4,0.003271,12,2,14,16,3,0.526316,0.583333,0,0.0007,10 - 14,#75FFF7
192,@imfnews,192,,21,0,21,0.044607,12,69,0,69,0,0,0,0,0.003717,10 - 14,#75FFF7
193,@ajaysk311,193,12,0,3,3,0,11,0,3,3,3,0.545455,0.611111,0,0.000446,10 - 14,#75FFF7
194,@intlfinancemag,194,452,0,1,1,0,31,0,1,1,3,0.5,0.537037,0,0.000446,Greater than 30,#FF7575
195,@wbg_gov,195,27487,1,1,2,0.001635,31,2,4,6,3,0.5,0.537037,0,0.000636,Greater than 30,#FF7575
196,@joniuwf,196,160,0,2,2,0,0,0,2,2,4,0.371429,0.413462,0,0.000446,0 - 4,#FF75FF
197,@james_tooley,197,,1,0,1,0.001635,0,1,0,1,0,0,0,0,0.000636,0 - 4,#FF75FF
198,@9999ahmadshanu,198,183,1,5,6,0.001635,11,1,35,36,3,0.590909,0.679487,0,0.000509,10 - 14,#75FFF7
199,@shivpalsyadav,199,,2,0,2,0.003592,11,8,0,8,0,0,0,0,0.000596,10 - 14,#75FFF7
200,@eduint,200,12314,12,11,23,0.026662,31,65,71,136,4,0.472222,0.590686,216.833333,0.001459,Greater than 30,#FF7575
201,@wbg_education,201,51756,2,2,4,0.007784,31,16,4,20,3,0.526316,0.583333,1,0.000749,Greater than 30,#FF7575
202,@jaimesaavedra22,202,,2,0,2,0.008844,31,11,0,11,0,0,0,0,0.000879,Greater than 30,#FF7575
203,@hari44114758,203,0,0,1,1,0,31,0,3,3,3,0.5,0.537037,0,0.000446,Greater than 30,#FF7575
204,@uclg_saiz,204,3955,0,3,3,0,12,0,3,3,3,0.55,0.621212,0,0.000446,10 - 14,#75FFF7
205,@timmyhotshot,205,28,0,1,1,0,31,0,1,1,3,0.5,0.537037,0,0.000446,Greater than 30,#FF7575
206,@shlokjbabu,206,182,1,3,4,0.001635,6,1,16,17,3,0.55,0.621212,0,0.000541, 5 - 9,FALSE
207,@httweets,207,6412553,2,0,2,0.003592,6,11,0,11,0,0,0,0,0.000695, 5 - 9,FALSE
208,@incindia,208,,2,0,2,0.003592,6,5,0,5,0,0,0,0,0.000695, 5 - 9,FALSE
209,@qualityinfo2017,209,450,0,1,1,0,5,0,1,1,4,0.366667,0.416667,0,0.000446, 5 - 9,FALSE
210,@undp_sdgs,210,894,5,2,7,0.008177,5,5,8,13,3,0.526316,0.583333,50,0.00216, 5 - 9,FALSE
211,@kraus33,211,533,0,8,8,0,7,0,8,8,3,0.64,0.739583,0,0.000446, 5 - 9,FALSE
212,@federalreserve,212,,1,0,1,0.001635,7,1,0,1,0,0,0,0,0.000493, 5 - 9,FALSE
213,@bis_org,213,,1,0,1,0.001635,7,1,0,1,0,0,0,0,0.000493, 5 - 9,FALSE
214,@ecb,214,,1,0,1,0.001635,7,1,0,1,0,0,0,0,0.000493, 5 - 9,FALSE
215,@bankofengland,215,,1,0,1,0.001635,7,1,0,1,0,0,0,0,0.000493, 5 - 9,FALSE
216,@centralbank_ie,216,,1,0,1,0.001635,7,1,0,1,0,0,0,0,0.000493, 5 - 9,FALSE
217,@newyorkfed,217,,1,0,1,0.001635,7,1,0,1,0,0,0,0,0.000493, 5 - 9,FALSE
218,@ugle_grandlodge,218,,1,0,1,0.001635,7,1,0,1,0,0,0,0,0.000493, 5 - 9,FALSE
219,@anwar96599668,219,1343,0,6,6,0,11,0,6,6,3,0.608696,0.702381,0,0.000446,10 - 14,#75FFF7
220,@prayag,220,86809,0,4,4,0,6,0,6,6,3,0.571429,0.652778,0,0.000446, 5 - 9,FALSE
221,@sirp_nigeria,221,634,1,6,7,0.00199,13,11,11,22,3,0.571429,0.641667,0,0.00049,10 - 14,#75FFF7
222,@somto_ugwu,222,1260,1,10,11,0.00199,13,2,66,68,3,0.645161,0.741667,4,0.000516,10 - 14,#75FFF7
223,@wbg_gender,223,12094,8,3,11,0.016413,13,20,35,55,3,0.541667,0.602564,4,0.001143,10 - 14,#75FFF7
224,@thesvri,224,,8,0,8,0.020336,13,29,0,29,0,0,0,0,0.001363,10 - 14,#75FFF7
225,@ythorg,225,6364,6,6,12,0.013727,13,21,6,27,3,0.590909,0.679487,16,0.001119,10 - 14,#75FFF7
226,@sirpprojects,226,,2,0,2,0.003981,13,13,0,13,0,0,0,0,0.00056,10 - 14,#75FFF7
227,@unfpa_youth,227,18,0,1,1,0,5,0,1,1,4,0.366667,0.416667,0,0.000446, 5 - 9,FALSE
228,@oak_institute,228,4981,19,28,47,0.052306,8,793,555,1348,3,0.454545,0.555556,768.266667,0.001455, 5 - 9,FALSE
229,@efraseroak,229,155,6,32,38,0.02331,8,79,100,179,3,0.517241,0.593651,485.316667,0.000655, 5 - 9,FALSE
230,@therulesorg,230,,2,0,2,0.013487,8,22,0,22,0,0,0,0,0.000515, 5 - 9,FALSE
231,@alnoorladha,231,,1,0,1,0.009526,8,21,0,21,0,0,0,0,0.00049, 5 - 9,FALSE
232,@brettonwoodspr,232,,2,0,2,0.013487,8,12,0,12,0,0,0,0,0.000515, 5 - 9,FALSE
233,@globaljusticeuk,233,,1,0,1,0.009526,8,11,0,11,0,0,0,0,0.00049, 5 - 9,FALSE
234,@nickdearden75,234,,1,0,1,0.009526,8,11,0,11,0,0,0,0,0.00049, 5 - 9,FALSE
235,@both_ends,235,,1,0,1,0.009526,8,11,0,11,0,0,0,0,0.00049, 5 - 9,FALSE
236,@worldruralforum,236,,1,0,1,0.009526,8,11,0,11,0,0,0,0,0.00049, 5 - 9,FALSE
237,@iam_anaveen,237,40,0,3,3,0,11,0,3,3,3,0.545455,0.611111,0,0.000446,10 - 14,#75FFF7
238,@vkraomovva,238,300,0,18,18,0,31,0,23,23,3,0.757576,0.853333,0,0.000446,Greater than 30,#FF7575
239,@lagarde,239,,2,0,2,0.003626,12,6,0,6,0,0,0,0,0.000496,10 - 14,#75FFF7
240,@sash2904,240,39,0,3,3,0,11,0,3,3,3,0.545455,0.611111,0,0.000446,10 - 14,#75FFF7
241,@actionaid_nl,241,1837,0,1,1,0,29,0,1,1,4,0.393939,0.442308,0,0.000446,25 - 29,#FFB175
242,@dannywijnhoud,242,5424,1,7,8,0.001635,29,1,19,20,3,0.6,0.694444,12,0.000827,25 - 29,#FFB175
243,@landacademy,243,,1,0,1,0.001957,29,1,0,1,0,0,0,0,0.000547,25 - 29,#FFB175
244,@actionaid_kenya,244,,1,0,1,0.001957,29,1,0,1,0,0,0,0,0.000547,25 - 29,#FFB175
245,@ghostwhotweetz,245,85,0,4,4,0,11,0,4,4,3,0.571429,0.652778,0,0.000446,10 - 14,#75FFF7
246,@mittaloak,246,2816,4,20,24,0.018476,8,62,478,540,4,0.460526,0.53254,301.083333,0.000584, 5 - 9,FALSE
247,@joshirakesh2004,247,2485,0,3,3,0,11,0,3,3,3,0.545455,0.611111,0,0.000446,10 - 14,#75FFF7
248,@kaenkay,248,1738,0,1,1,0,31,0,1,1,3,0.5,0.537037,0,0.000446,Greater than 30,#FF7575
249,@ghassanhalawa,249,2900,0,2,2,0,31,0,2,2,3,0.526316,0.583333,0,0.000446,Greater than 30,#FF7575
250,@parachute16me,250,819,2,1,3,0.003271,31,2,4,6,3,0.5,0.537037,0,0.000827,Greater than 30,#FF7575
251,@unpeacebuilding,251,9517,0,1,1,0,5,0,1,1,4,0.366667,0.416667,0,0.000446, 5 - 9,FALSE
252,@murali21272,252,429,0,3,3,0,11,0,3,3,3,0.545455,0.611111,0,0.000446,10 - 14,#75FFF7
253,@ferval100,253,5200,0,2,2,0,31,0,2,2,5,0.353535,0.415238,0,0.000446,Greater than 30,#FF7575
254,@monkee_bath,254,16,0,2,2,0,11,0,2,2,4,0.387097,0.465278,0,0.000446,10 - 14,#75FFF7
255,@yogesh_htin,255,542,0,3,3,0,11,0,3,3,3,0.545455,0.611111,0,0.000446,10 - 14,#75FFF7
256,@realdonaldtrump,256,,3,0,3,0.005616,12,6,0,6,0,0,0,0,0.000598,10 - 14,#75FFF7
257,@putinrf_eng,257,,1,0,1,0.001635,31,1,0,1,0,0,0,0,0.000467,Greater than 30,#FF7575
258,@emmanuelmacron,258,,1,0,1,0.001635,31,1,0,1,0,0,0,0,0.000467,Greater than 30,#FF7575
259,@theresa_may,259,,5,0,5,0.011812,28,15,0,15,0,0,0,0,0.000724,25 - 29,#FFB175
260,@xijinping,260,,1,0,1,0.001635,31,1,0,1,0,0,0,0,0.000467,Greater than 30,#FF7575
261,@g20live,261,,1,0,1,0.001635,31,1,0,1,0,0,0,0,0.000467,Greater than 30,#FF7575
262,@commonwealthsec,262,,1,0,1,0.001635,31,1,0,1,0,0,0,0,0.000467,Greater than 30,#FF7575
263,@antonioguterres,263,,1,0,1,0.001635,31,1,0,1,0,0,0,0,0.000467,Greater than 30,#FF7575
264,@devfinancenews,264,13305,0,4,4,0,0,0,5,5,3,0.48,0.597222,0,0.000446,0 - 4,#FF75FF
265,@edfinetwork,265,,1,0,1,0.001635,0,1,0,1,0,0,0,0,0.000541,0 - 4,#FF75FF
266,@cdcgov,266,,1,0,1,0.001635,0,1,0,1,0,0,0,0,0.000541,0 - 4,#FF75FF
267,@blavatnikschool,267,,1,0,1,0.001635,0,1,0,1,0,0,0,0,0.000541,0 - 4,#FF75FF
268,@klrana54,268,338,0,4,4,0,11,0,4,4,3,0.571429,0.652778,0,0.000446,10 - 14,#75FFF7
269,@farisalahmad2,269,5152,0,2,2,0,31,0,2,2,3,0.526316,0.583333,0,0.000446,Greater than 30,#FF7575
270,@rotr_jude,270,5662,0,1,1,0,31,0,1,1,3,0.5,0.537037,0,0.000446,Greater than 30,#FF7575
271,@mwebembezialber,271,33,0,1,1,0,31,0,1,1,3,0.5,0.537037,0,0.000446,Greater than 30,#FF7575
272,@florasonkin,272,273,3,50,53,0.010936,8,3,949,952,3,0.610465,0.715873,479.166667,0.000552, 5 - 9,FALSE
273,@nathalievharen,273,,1,0,1,0.003106,8,1,0,1,0,0,0,0,0.000455, 5 - 9,FALSE
274,@centerofconcern,274,,1,0,1,0.003106,8,1,0,1,0,0,0,0,0.000455, 5 - 9,FALSE
275,@olumideidowu,275,,1,0,1,0.003106,8,1,0,1,0,0,0,0,0.000455, 5 - 9,FALSE
276,@biofuelwatch,276,,2,0,2,0.012632,8,11,0,11,0,0,0,0,0.0005, 5 - 9,FALSE
277,@sid_int,277,,1,0,1,0.003106,8,1,0,1,0,0,0,0,0.000455, 5 - 9,FALSE
278,@sideastafrica,278,,1,0,1,0.003106,8,1,0,1,0,0,0,0,0.000455, 5 - 9,FALSE
279,@democracycenter,279,,2,0,2,0.012632,8,11,0,11,0,0,0,0,0.0005, 5 - 9,FALSE
280,@grain_org,280,,3,0,3,0.009659,8,11,0,11,0,0,0,0,0.000493, 5 - 9,FALSE
281,@mikaelbergius,281,,1,0,1,0.003106,8,1,0,1,0,0,0,0,0.000455, 5 - 9,FALSE
282,@via_campesina,282,,5,0,5,0.023568,8,63,0,63,0,0,0,0,0.000605, 5 - 9,FALSE
283,@ecvc1,283,,2,0,2,0.012632,8,23,0,23,0,0,0,0,0.0005, 5 - 9,FALSE
284,@manufian,284,,4,0,4,0.014043,8,33,0,33,0,0,0,0,0.000561, 5 - 9,FALSE
285,@meyernathaniel,285,,1,0,1,0.003106,8,1,0,1,0,0,0,0,0.000455, 5 - 9,FALSE
286,@jandrosov,286,947,1,2,3,0.003106,8,1,3,4,4,0.324074,0.362698,0,0.000455, 5 - 9,FALSE
287,@focussouth,287,,2,0,2,0.005697,8,2,0,2,0,0,0,0,0.000468, 5 - 9,FALSE
288,@jasonhickel,288,,1,0,1,0.003106,8,2,0,2,0,0,0,0,0.000455, 5 - 9,FALSE
289,@janhavimittal,289,79,2,32,34,0.007068,8,20,57,77,3,0.502392,0.596825,269.416667,0.00048, 5 - 9,FALSE
290,@flaviabustreo,290,4845,0,3,3,0,9,0,3,3,4,0.421053,0.505208,0,0.000446, 5 - 9,FALSE
291,@lgostin,291,1680,7,7,14,0.021066,9,12,56,68,3,0.625,0.722222,52,0.001191, 5 - 9,FALSE
292,@oneillinstitute,292,1631,5,3,8,0.01477,9,13,4,17,4,0.405405,0.472222,0,0.00104, 5 - 9,FALSE
293,@benjaminmmeier,293,1783,4,5,9,0.011823,9,11,10,21,4,0.405405,0.472222,0,0.001141, 5 - 9,FALSE
294,@who,294,,3,0,3,0.008645,9,13,0,13,0,0,0,0,0.0007, 5 - 9,FALSE
295,@ilo,295,,1,0,1,0.004731,9,8,0,8,0,0,0,0,0.000591, 5 - 9,FALSE
296,@unfpa,296,,1,0,1,0.004731,9,8,0,8,0,0,0,0,0.000591, 5 - 9,FALSE
297,@unhumanrights,297,,1,0,1,0.004731,9,8,0,8,0,0,0,0,0.000591, 5 - 9,FALSE
298,@meenakshibdutt,298,73,0,3,3,0,11,0,3,3,3,0.545455,0.611111,0,0.000446,10 - 14,#75FFF7
299,@clairecschouten,299,1558,0,2,2,0,31,0,3,3,3,0.526316,0.583333,0,0.000446,Greater than 30,#FF7575
300,@yowork,300,850,0,2,2,0,12,0,2,2,4,0.393939,0.467949,0,0.000446,10 - 14,#75FFF7
301,@bccoalitionnl,301,210,5,4,9,0.008498,12,8,32,40,3,0.571429,0.652778,38,0.001344,10 - 14,#75FFF7
302,@sigridkaag,302,,5,0,5,0.009816,12,12,0,12,0,0,0,0,0.001399,10 - 14,#75FFF7
303,@renepdv,303,,1,0,1,0.003275,12,8,0,8,0,0,0,0,0.000732,10 - 14,#75FFF7
304,@includeplatform,304,1897,0,1,1,0,31,0,1,1,3,0.5,0.537037,0,0.000446,Greater than 30,#FF7575
305,@sheilakulubya,305,2887,1,3,4,0.002669,29,3,3,6,3,0.541667,0.602564,0,0.000582,25 - 29,#FFB175
306,@ds_dubois,306,668,3,5,8,0.005648,29,7,15,22,3,0.590909,0.679487,10,0.000799,25 - 29,#FFB175
307,@diop_wb,307,,2,0,2,0.004725,29,4,0,4,0,0,0,0,0.000748,25 - 29,#FFB175
308,@wbtanzania,308,,1,0,1,0.002669,29,3,0,3,0,0,0,0,0.000582,25 - 29,#FFB175
309,@worldbankafrica,309,352753,7,2,9,0.012803,29,11,26,37,3,0.529412,0.592593,9.5,0.001462,25 - 29,#FFB175
310,@obidi_ok,310,159,0,3,3,0,10,0,3,3,3,0.55,0.621212,0,0.000446,10 - 14,#75FFF7
311,@elrufai,311,,3,0,3,0.005228,10,5,0,5,0,0,0,0,0.000863,10 - 14,#75FFF7
312,@apcnigeria,312,,1,0,1,0.001635,10,1,0,1,0,0,0,0,0.000573,10 - 14,#75FFF7
313,@ignited_indian,313,196,0,3,3,0,11,0,3,3,3,0.545455,0.611111,0,0.000446,10 - 14,#75FFF7
314,@siddarthasg,314,106,0,3,3,0,11,0,3,3,3,0.545455,0.611111,0,0.000446,10 - 14,#75FFF7
315,@ninodesantis1,315,251,0,6,6,0,31,0,40,40,3,0.55,0.621212,0,0.000446,Greater than 30,#FF7575
316,@cesahafrica,316,158,0,8,8,0,31,0,8,8,3,0.652174,0.755556,0,0.000446,Greater than 30,#FF7575
317,@yates_rob,317,7045,2,8,10,0.003271,31,2,56,58,3,0.636364,0.738095,3,0.00057,Greater than 30,#FF7575
318,@billgates,318,,3,0,3,0.005549,31,6,0,6,0,0,0,0,0.00063,Greater than 30,#FF7575
319,@pennymordaunt,319,,7,0,7,0.026158,8,42,0,42,0,0,0,0,0.000756, 5 - 9,FALSE
320,@jimyongkim,320,,14,0,14,0.194601,29,75,0,75,0,0,0,0,0.01772,25 - 29,#FFB175
321,@dfid_uk,321,,10,0,10,0.034001,8,55,0,55,0,0,0,0,0.000996, 5 - 9,FALSE
322,@drtedros,322,,2,0,2,0.003914,31,5,0,5,0,0,0,0,0.000554,Greater than 30,#FF7575
323,@mfkosovo,323,992,0,2,2,0,31,0,2,2,3,0.526316,0.583333,0,0.000446,Greater than 30,#FF7575
324,@petrit,324,51575,5,1,6,0.008177,31,5,10,15,3,0.5,0.537037,0,0.001398,Greater than 30,#FF7575
325,@unfoundation,325,550901,3,2,5,0.004906,31,3,2,5,3,0.526316,0.583333,0,0.000827,Greater than 30,#FF7575
326,@globalgoalsun,326,250517,14,1,15,0.023859,31,14,22,36,3,0.5,0.537037,0,0.002989,Greater than 30,#FF7575
327,@donaldplawson,327,34,0,7,7,0,31,0,7,7,3,0.625,0.722222,0,0.000446,Greater than 30,#FF7575
328,@bsebti,328,11680,3,3,6,0.004906,31,3,3,6,3,0.526316,0.583333,11,0.000929,Greater than 30,#FF7575
329,@michpabsy,329,,1,0,1,0.001635,31,1,0,1,0,0,0,0,0.0005,Greater than 30,#FF7575
330,@zubie3,330,724,3,1,4,0.006193,31,3,4,7,3,0.5,0.537037,0,0.000901,Greater than 30,#FF7575
331,@chinaopenmic,331,,1,0,1,0.001635,31,1,0,1,0,0,0,0,0.0005,Greater than 30,#FF7575
332,@chrismontgomery,332,,1,0,1,0.001635,31,1,0,1,0,0,0,0,0.0005,Greater than 30,#FF7575
333,@_carlosferreyra,333,,1,0,1,0.001635,31,1,0,1,0,0,0,0,0.0005,Greater than 30,#FF7575
334,@lowriejohn,334,397,1,4,5,0.00199,31,3,6,9,3,0.55,0.621212,0,0.000446,Greater than 30,#FF7575
335,@devex,335,77037,2,2,4,0.003626,31,2,6,8,3,0.526316,0.583333,0,0.000668,Greater than 30,#FF7575
336,@being_vinay82,336,778,0,3,3,0,11,0,3,3,3,0.545455,0.611111,0,0.000446,10 - 14,#75FFF7
337,@glenn_swart,337,3454,0,3,3,0,31,0,3,3,3,0.55,0.621212,0,0.000446,Greater than 30,#FF7575
338,@shopperann68,338,3173,0,5,5,0,8,0,5,5,4,0.326154,0.375786,0,0.000446, 5 - 9,FALSE
339,@usaid,339,,8,0,8,0.028111,8,45,0,45,0,0,0,0,0.000939, 5 - 9,FALSE
340,@dfid,340,,3,0,3,0.015885,8,12,0,12,0,0,0,0,0.000584, 5 - 9,FALSE
341,@gatesfoundation,341,,10,0,10,0.034897,8,74,0,74,0,0,0,0,0.000958, 5 - 9,FALSE
342,@stopcorpabuse,342,,2,0,2,0.012632,8,11,0,11,0,0,0,0,0.0005, 5 - 9,FALSE
343,@agrawatch,343,,2,0,2,0.012632,8,50,0,50,0,0,0,0,0.0005, 5 - 9,FALSE
344,@food_democracy,344,,2,0,2,0.012632,8,11,0,11,0,0,0,0,0.0005, 5 - 9,FALSE
345,@carolyn_gaspar,345,12,3,5,8,0.006505,12,7,14,21,3,0.545455,0.611111,4,0.000961,10 - 14,#75FFF7
346,@bworldph,346,30397,1,2,3,0.001635,31,1,8,9,3,0.526316,0.583333,0,0.000573,Greater than 30,#FF7575
347,@elijahtubayan,347,,2,0,2,0.003592,31,5,0,5,0,0,0,0,0.000817,Greater than 30,#FF7575
348,@heatherpinnock,348,5195,0,1,1,0,31,0,1,1,3,0.5,0.537037,0,0.000446,Greater than 30,#FF7575
349,@dimafreedoom,349,4024,0,2,2,0,31,0,2,2,3,0.52381,0.575758,0,0.000446,Greater than 30,#FF7575
350,@alt_estate,350,5868,8,2,10,0.013082,31,8,32,40,3,0.526316,0.583333,8,0.00197,Greater than 30,#FF7575
351,@businesstimes,351,,1,0,1,0.004209,31,16,0,16,0,0,0,0,0.001286,Greater than 30,#FF7575
352,@gojovenphi,352,,1,0,1,0.003934,13,1,0,1,0,0,0,0,0.000605,10 - 14,#75FFF7
353,@phi_research,353,,1,0,1,0.003934,13,1,0,1,0,0,0,0,0.000605,10 - 14,#75FFF7
354,@anonymousstarrr,354,38,0,3,3,0,11,0,3,3,3,0.545455,0.611111,0,0.000446,10 - 14,#75FFF7
355,@andriancandu,355,685,1,1,2,0.001635,31,1,3,4,3,0.5,0.537037,0,0.000636,Greater than 30,#FF7575
356,@economiadelagua,356,2163,2,1,3,0.003271,31,2,3,5,3,0.5,0.537037,18,0.001208,Greater than 30,#FF7575
357,@bboy_vino,357,3284,0,2,2,0,31,0,2,2,3,0.52381,0.575758,0,0.000446,Greater than 30,#FF7575
358,@miky_bdolino,358,44,0,3,3,0,31,0,3,3,3,0.55,0.621212,0,0.000446,Greater than 30,#FF7575
359,@unwomenarabic,359,7696,7,2,9,0.011447,31,7,42,49,3,0.526316,0.583333,0,0.001335,Greater than 30,#FF7575
360,@sarah_iqbal,360,,8,0,8,0.015334,31,28,0,28,0,0,0,0,0.001904,Greater than 30,#FF7575
361,@yusufsgiwa,361,58,0,3,3,0,10,0,3,3,3,0.545455,0.611111,0,0.000446,10 - 14,#75FFF7
362,@saharareporters,362,1967990,1,3,4,0.001635,10,1,9,10,3,0.55,0.621212,1,0.000573,10 - 14,#75FFF7
363,@ngrsenate,363,,1,0,1,0.001957,10,3,0,3,0,0,0,0,0.000609,10 - 14,#75FFF7
364,@smarcelaochoa,364,323,0,3,3,0,8,0,3,3,4,0.324159,0.366352,0,0.000446, 5 - 9,FALSE
365,@ifadnews,365,,3,0,3,0.015885,8,8,0,8,0,0,0,0,0.000635, 5 - 9,FALSE
366,@usaidmarkgreen,366,,4,0,4,0.020609,8,36,0,36,0,0,0,0,0.000571, 5 - 9,FALSE
367,@moitraabhijit4,367,38,1,1,2,0.001635,31,1,3,4,3,0.5,0.537037,0,0.000636,Greater than 30,#FF7575
368,@fianbelgium,368,,1,0,1,0.009526,8,11,0,11,0,0,0,0,0.00049, 5 - 9,FALSE
369,@pcgtw,369,,1,0,1,0.009526,8,11,0,11,0,0,0,0,0.00049, 5 - 9,FALSE
370,@digihunk,370,2431,0,2,2,0,31,0,2,2,3,0.526316,0.583333,0,0.000446,Greater than 30,#FF7575
371,@ashwin28,371,175,0,4,4,0,11,0,4,4,3,0.571429,0.652778,0,0.000446,10 - 14,#75FFF7
372,@bjp4india,372,,1,0,1,0.001635,11,1,0,1,0,0,0,0,0.000541,10 - 14,#75FFF7
373,@pmoindia,373,,1,0,1,0.001635,11,1,0,1,0,0,0,0,0.000541,10 - 14,#75FFF7
374,@sustainus,374,9593,4,1,5,0.011453,31,6,5,11,3,0.5,0.537037,0,0.00086,Greater than 30,#FF7575
375,@loicveza,375,172,1,3,4,0.002806,12,5,3,8,3,0.545455,0.611111,1,0.000674,10 - 14,#75FFF7
376,@future_unsecgen,376,56,0,2,2,0,31,0,2,2,3,0.526316,0.583333,0,0.000446,Greater than 30,#FF7575
377,@robertrlucas,377,2574,0,2,2,0,31,0,6,6,3,0.526316,0.583333,0,0.000446,Greater than 30,#FF7575
378,@wbtreasurer,378,23632,3,1,4,0.004906,31,5,10,15,3,0.5,0.537037,0,0.001017,Greater than 30,#FF7575
379,@ipupresident,379,4746,6,4,10,0.013515,12,9,61,70,3,0.56,0.630952,15,0.001327,10 - 14,#75FFF7
380,@ipuparliament,380,15496,5,3,8,0.01045,12,24,3,27,3,0.5,0.571429,0,0.001072,10 - 14,#75FFF7
381,@09_urbina,381,57,0,1,1,0,0,0,1,1,4,0.37931,0.431818,0,0.000446,0 - 4,#FF75FF
382,@winifreddoherty,382,724,0,1,1,0,31,0,1,1,3,0.5,0.537037,0,0.000446,Greater than 30,#FF7575
383,@angelrangels,383,17722,0,2,2,0,31,0,2,2,3,0.521739,0.569444,0,0.000446,Greater than 30,#FF7575
384,@wbg_climate,384,93075,3,1,4,0.005871,31,4,1,5,3,0.5,0.537037,0,0.000984,Greater than 30,#FF7575
385,@bancomundiallac,385,,1,0,1,0.002279,31,2,0,2,0,0,0,0,0.000681,Greater than 30,#FF7575
386,@profvnsharma,386,751,0,3,3,0,31,0,3,3,3,0.55,0.621212,0,0.000446,Greater than 30,#FF7575
387,@salomnm,387,3586,0,1,1,0,0,0,1,1,4,0.37931,0.431818,0,0.000446,0 - 4,#FF75FF
388,@mosesntenga,388,514,1,4,5,0.00199,13,1,4,5,3,0.571429,0.652778,0,0.00049,10 - 14,#75FFF7
389,@joyforchildren,389,,2,0,2,0.003981,13,2,0,2,0,0,0,0,0.000594,10 - 14,#75FFF7
390,@vnayebare,390,,2,0,2,0.003981,13,2,0,2,0,0,0,0,0.000594,10 - 14,#75FFF7
391,@kiosfoundation,391,,2,0,2,0.003981,13,2,0,2,0,0,0,0,0.000594,10 - 14,#75FFF7
392,@wbg_fin4dev,392,10554,0,1,1,0,31,0,1,1,3,0.5,0.537037,0,0.000446,Greater than 30,#FF7575
393,@markrwri,393,1517,0,3,3,0,5,0,3,3,3,0.55,0.621212,0,0.000446, 5 - 9,FALSE
394,@wrigovernance,394,,1,0,1,0.001635,5,1,0,1,0,0,0,0,0.000573, 5 - 9,FALSE
395,@scalingoffgrid,395,1853,2,5,7,0.003271,31,2,15,17,3,0.590909,0.679487,4,0.000636,Greater than 30,#FF7575
396,@dlightdesign,396,,2,0,2,0.003914,31,4,0,4,0,0,0,0,0.000618,Greater than 30,#FF7575
397,@mkopasolar,397,,2,0,2,0.003914,31,4,0,4,0,0,0,0,0.000618,Greater than 30,#FF7575
398,@bboxx_hq,398,,2,0,2,0.003914,31,4,0,4,0,0,0,0,0.000618,Greater than 30,#FF7575
399,@lumosglobal,399,,2,0,2,0.003914,31,4,0,4,0,0,0,0,0.000618,Greater than 30,#FF7575
400,@doublejeopardee,400,69,0,2,2,0,31,0,4,4,3,0.526316,0.583333,0,0.000446,Greater than 30,#FF7575
401,@wbg_health,401,,6,0,6,0.009812,31,9,0,9,0,0,0,0,0.001589,Greater than 30,#FF7575
402,@djdangi,402,755,0,1,1,0,31,0,1,1,3,0.5,0.537037,0,0.000446,Greater than 30,#FF7575
403,@lindsaycoates,403,442,2,4,6,0.023719,31,6,5,11,2,0.615385,0.6875,0.5,0.004309,Greater than 30,#FF7575
404,@ngovoices,404,2164,0,4,4,0,31,0,6,6,2,0.6,0.666667,0,0.000446,Greater than 30,#FF7575
405,@kebinsoreasmey,405,474,0,1,1,0,31,0,1,1,3,0.5,0.537037,0,0.000446,Greater than 30,#FF7575
406,@plus_socialgood,406,48927,0,2,2,0,31,0,2,2,3,0.526316,0.583333,0,0.000446,Greater than 30,#FF7575
407,@edo_seefor,407,65,0,5,5,0,14,0,5,5,3,0.590909,0.679487,0,0.000446,10 - 14,#75FFF7
408,@tonaiwu,408,,1,0,1,0.001635,14,1,0,1,0,0,0,0,0.000522,10 - 14,#75FFF7
409,@governorobaseki,409,,1,0,1,0.001635,14,1,0,1,0,0,0,0,0.000522,10 - 14,#75FFF7
410,@edostategovt,410,,1,0,1,0.001635,14,1,0,1,0,0,0,0,0.000522,10 - 14,#75FFF7
411,@europeunion,411,,1,0,1,0.001635,14,1,0,1,0,0,0,0,0.000522,10 - 14,#75FFF7
412,@10ly,412,768,0,3,3,0,31,0,4,4,3,0.535714,0.588889,0,0.000446,Greater than 30,#FF7575
413,@javier_montiel,413,112,0,1,1,0,0,0,1,1,4,0.37931,0.431818,0,0.000446,0 - 4,#FF75FF
414,@shgosalci,414,464,0,2,2,0,31,0,2,2,3,0.526316,0.583333,0,0.000446,Greater than 30,#FF7575
415,@nicschiegg,415,2806,0,8,8,0,31,0,8,8,3,0.560976,0.652174,0,0.000446,Greater than 30,#FF7575
416,@malakagharib,416,,1,0,1,0.001635,31,1,0,1,0,0,0,0,0.000493,Greater than 30,#FF7575
417,@imf,417,,1,0,1,0.001635,31,1,0,1,0,0,0,0,0.000493,Greater than 30,#FF7575
418,@tkb,418,,1,0,1,0.001635,31,1,0,1,0,0,0,0,0.000493,Greater than 30,#FF7575
419,@sarahjacksonhan,419,3505,1,5,6,0.001635,31,1,6,7,3,0.576923,0.655556,6,0.000493,Greater than 30,#FF7575
420,@aidthoughts,420,,1,0,1,0.001635,31,1,0,1,0,0,0,0,0.000493,Greater than 30,#FF7575
421,@nmeda_officiel,421,,1,0,1,0.001635,31,1,0,1,0,0,0,0,0.000493,Greater than 30,#FF7575
422,@born27354707,422,28,0,3,3,0,31,0,5,5,3,0.55,0.621212,0,0.000446,Greater than 30,#FF7575
423,@ivankatrump,423,,1,0,1,0.001635,31,2,0,2,0,0,0,0,0.000573,Greater than 30,#FF7575
424,@shsanders45,424,,1,0,1,0.001635,31,1,0,1,0,0,0,0,0.000573,Greater than 30,#FF7575
425,@armellekiyak,425,0,0,4,4,0,31,0,4,4,2,0.642857,0.722222,0,0.000446,Greater than 30,#FF7575
426,@fami_org,426,42,0,6,6,0,8,0,10,10,4,0.377224,0.424528,0,0.000446, 5 - 9,FALSE
427,@redaviasolar,427,292,1,4,5,0.003933,5,8,4,12,3,0.533333,0.576389,0,0.000583, 5 - 9,FALSE
428,@shellfoundation,428,,3,0,3,0.007747,5,10,0,10,0,0,0,0,0.000803, 5 - 9,FALSE
429,@rafiki_power,429,,1,0,1,0.003933,5,8,0,8,0,0,0,0,0.000583, 5 - 9,FALSE
430,@steamaco,430,,1,0,1,0.003933,5,8,0,8,0,0,0,0,0.000583, 5 - 9,FALSE
431,@engiegroup,431,,1,0,1,0.003933,5,8,0,8,0,0,0,0,0.000583, 5 - 9,FALSE
432,@powergen_re,432,,1,0,1,0.003933,5,8,0,8,0,0,0,0,0.000583, 5 - 9,FALSE
433,@powerhive,433,,1,0,1,0.003933,5,8,0,8,0,0,0,0,0.000583, 5 - 9,FALSE
434,@rvesol,434,,1,0,1,0.003933,5,8,0,8,0,0,0,0,0.000583, 5 - 9,FALSE
435,@cookytitacookie,435,221,0,3,3,0,31,0,3,3,3,0.55,0.621212,0,0.000446,Greater than 30,#FF7575
436,@ajaykum70347445,436,14,0,3,3,0,11,0,3,3,3,0.545455,0.611111,0,0.000446,10 - 14,#75FFF7
437,@wbg_cities,437,40844,0,2,2,0,31,0,2,2,3,0.521739,0.569444,0,0.000446,Greater than 30,#FF7575
438,@lourebas,438,796,0,1,1,0,31,0,1,1,3,0.5,0.537037,0,0.000446,Greater than 30,#FF7575
439,@worldbankwater,439,63951,8,1,9,0.013082,31,12,8,20,3,0.5,0.537037,63,0.002922,Greater than 30,#FF7575
440,@unlibrary,440,56880,4,1,5,0.006541,31,4,9,13,3,0.5,0.537037,0,0.001208,Greater than 30,#FF7575
441,@olatahmed,441,479,0,1,1,0,31,0,1,1,4,0.357143,0.408333,0,0.000446,Greater than 30,#FF7575
442,@anilvegomega,442,3126,0,3,3,0,11,0,3,3,3,0.545455,0.611111,0,0.000446,10 - 14,#75FFF7
443,@natashatynes,443,8916,0,1,1,0,31,0,1,1,4,0.366667,0.416667,0,0.000446,Greater than 30,#FF7575
444,@luqmansheikh,444,601,0,2,2,0,31,0,2,2,3,0.526316,0.583333,0,0.000446,Greater than 30,#FF7575
445,@abhimarkhedkar,445,202,0,3,3,0,11,0,3,3,3,0.545455,0.611111,0,0.000446,10 - 14,#75FFF7
446,@vvpvku,446,154,1,4,5,0.001635,11,1,4,5,3,0.571429,0.652778,0,0.000522,10 - 14,#75FFF7
447,@subratpatra13,447,21,0,3,3,0,11,0,3,3,3,0.545455,0.611111,0,0.000446,10 - 14,#75FFF7
448,@rothcocpa,448,260,0,2,2,0,15,0,2,2,4,0.357143,0.408333,0,0.000446,15 - 19,#75FF79
449,@pwc,449,81071,3,1,4,0.004906,15,3,1,4,3,0.5,0.537037,18,0.001017,15 - 19,#75FF79
450,@ambassad_air,450,519,1,3,4,0.00199,12,2,4,6,4,0.42,0.488095,0,0.000509,10 - 14,#75FFF7
451,@marcharlott,451,6301,1,8,9,0.00199,12,1,25,26,3,0.567568,0.666667,8.5,0.000591,10 - 14,#75FFF7
452,@metropolerennes,452,,2,0,2,0.003981,12,3,0,3,0,0,0,0,0.000654,10 - 14,#75FFF7
453,@airqualityasia,453,203,5,4,9,0.011161,12,17,16,33,3,0.56,0.630952,26.5,0.001089,10 - 14,#75FFF7
454,@villessanteoms,454,,1,0,1,0.00199,12,2,0,2,0,0,0,0,0.000509,10 - 14,#75FFF7
455,@who_europe_hcn,455,,1,0,1,0.00199,12,2,0,2,0,0,0,0,0.000509,10 - 14,#75FFF7
456,@breathelife2030,456,,1,0,1,0.00199,12,2,0,2,0,0,0,0,0.000509,10 - 14,#75FFF7
457,@drmarianeira,457,,1,0,1,0.00199,12,2,0,2,0,0,0,0,0.000509,10 - 14,#75FFF7
458,@ankush25,458,468,0,4,4,0,11,0,4,4,3,0.571429,0.652778,0,0.000446,10 - 14,#75FFF7
459,@faryus88,459,2260,0,2,2,0,31,0,2,2,3,0.526316,0.583333,0,0.000446,Greater than 30,#FF7575
460,@perugbc,460,,1,0,1,0.001957,0,3,0,3,0,0,0,0,0.000554,0 - 4,#FF75FF
461,@armeniasdglab,461,352,0,2,2,0,31,0,2,2,3,0.526316,0.583333,0,0.000446,Greater than 30,#FF7575
462,@nldigitaldelta,462,1029,0,4,4,0,12,0,5,5,3,0.56,0.630952,0,0.000446,10 - 14,#75FFF7
463,@nomoreslaves,463,15471,0,2,2,0,31,0,2,2,3,0.526316,0.583333,0,0.000446,Greater than 30,#FF7575
464,@sjohannisse,464,2066,1,2,3,0.001635,12,1,6,7,3,0.52,0.564103,0,0.000541,10 - 14,#75FFF7
465,@mados7mohamed,465,2508,0,1,1,0,31,0,1,1,4,0.357143,0.408333,0,0.000446,Greater than 30,#FF7575
466,@ministerwhrd,466,3987,1,1,2,0.001635,31,1,1,2,3,0.5,0.537037,9,0.000827,Greater than 30,#FF7575
467,@arlettedehaas,467,92,0,2,2,0,12,0,2,2,4,0.393939,0.467949,0,0.000446,10 - 14,#75FFF7
468,@inclusivecap,468,15503,0,1,1,0,31,0,1,1,3,0.5,0.537037,0,0.000446,Greater than 30,#FF7575
469,@dr_pjd,469,39,0,1,1,0,5,0,1,1,4,0.366667,0.416667,0,0.000446, 5 - 9,FALSE
470,@gwuglobalwomen,470,2115,2,1,3,0.003592,31,2,2,4,3,0.5,0.537037,0,0.000584,Greater than 30,#FF7575
471,@sdonnan,471,16021,0,2,2,0,31,0,2,2,3,0.526316,0.583333,0,0.000446,Greater than 30,#FF7575
472,@alterigoe,472,3027,2,1,3,0.003271,31,2,4,6,3,0.5,0.537037,0,0.000827,Greater than 30,#FF7575
473,@sachira_mr,473,2220,0,2,2,0,31,0,2,2,3,0.52381,0.575758,0,0.000446,Greater than 30,#FF7575
474,@danishmfa,474,,4,0,4,0.018476,8,13,0,13,0,0,0,0,0.000647, 5 - 9,FALSE
475,@dutchmfa,475,,4,0,4,0.018476,8,13,0,13,0,0,0,0,0.000647, 5 - 9,FALSE
476,@melasnk,476,14227,0,2,2,0,31,0,2,2,3,0.52381,0.575758,0,0.000446,Greater than 30,#FF7575
477,@g20org,477,,1,0,1,0.001635,31,1,0,1,0,0,0,0,0.000467,Greater than 30,#FF7575
478,@washingtondc,478,,1,0,1,0.001635,31,1,0,1,0,0,0,0,0.000467,Greater than 30,#FF7575
479,@reuters,479,,1,0,1,0.001635,31,1,0,1,0,0,0,0,0.000467,Greater than 30,#FF7575
480,@bbcworld,480,,3,0,3,0.004906,36,3,0,3,0,0,0,0,0.000534,Greater than 30,#FF7575
481,@tassagency_en,481,,1,0,1,0.001635,31,1,0,1,0,0,0,0,0.000467,Greater than 30,#FF7575
482,@vaidypgt,482,183,0,6,6,0,11,0,10,10,4,0.454545,0.605556,0,0.000446,10 - 14,#75FFF7
483,@sardesairajdeep,483,,1,0,1,0.001635,11,1,0,1,0,0,0,0,0.000509,10 - 14,#75FFF7
484,@sagarikaghose,484,,1,0,1,0.001635,11,1,0,1,0,0,0,0,0.000509,10 - 14,#75FFF7
485,@rajeev_mp,485,,1,0,1,0.001635,11,1,0,1,0,0,0,0,0.000509,10 - 14,#75FFF7
486,@cicodevafrica,486,,2,0,2,0.008686,8,20,0,20,0,0,0,0,0.000488, 5 - 9,FALSE
487,@iccaworld,487,,2,0,2,0.008686,8,10,0,10,0,0,0,0,0.000488, 5 - 9,FALSE
488,@chikikothari,488,,2,0,2,0.008686,8,11,0,11,0,0,0,0,0.000488, 5 - 9,FALSE
489,@_acbio,489,,1,0,1,0.003962,8,20,0,20,0,0,0,0,0.000471, 5 - 9,FALSE
490,@fundagroecology,490,,1,0,1,0.003962,8,20,0,20,0,0,0,0,0.000471, 5 - 9,FALSE
491,@11thhourproject,491,,1,0,1,0.003962,8,19,0,19,0,0,0,0,0.000471, 5 - 9,FALSE
492,@1000currents,492,,3,0,3,0.010321,8,21,0,21,0,0,0,0,0.000552, 5 - 9,FALSE
493,@jmilton2016,493,202,0,4,4,0,12,0,4,4,3,0.517241,0.6,0,0.000446,10 - 14,#75FFF7
494,@lokimaros,494,1354,0,2,2,0,31,0,2,2,3,0.526316,0.583333,0,0.000446,Greater than 30,#FF7575
495,@kurant82,495,6011,0,2,2,0,31,0,2,2,3,0.52381,0.575758,0,0.000446,Greater than 30,#FF7575
496,@gursatinder68,496,131,0,4,4,0,11,0,4,4,3,0.571429,0.652778,0,0.000446,10 - 14,#75FFF7
497,@agavrielatos,497,1752,1,8,9,0.00199,31,9,19,28,5,0.39604,0.507083,0,0.000499,Greater than 30,#FF7575
498,@jonavon1963,498,182,1,8,9,0.00199,31,1,90,91,5,0.39604,0.507083,0,0.000499,Greater than 30,#FF7575
499,@sadtunational,499,,2,0,2,0.003981,31,10,0,10,0,0,0,0,0.000552,Greater than 30,#FF7575
500,@_cosatu,500,,2,0,2,0.003981,31,10,0,10,0,0,0,0,0.000552,Greater than 30,#FF7575
501,@dbe_sa,501,,2,0,2,0.003981,31,10,0,10,0,0,0,0,0.000552,Greater than 30,#FF7575
502,@capetalk,502,,2,0,2,0.003981,31,10,0,10,0,0,0,0,0.000552,Greater than 30,#FF7575
503,@vaidyabr,503,199,0,3,3,0,11,0,3,3,3,0.545455,0.611111,0,0.000446,10 - 14,#75FFF7
504,@dasmaitreyi,504,2177,0,4,4,0,13,0,4,4,3,0.56,0.630952,0,0.000446,10 - 14,#75FFF7
505,@kodaganallur,505,88,0,3,3,0,11,0,3,3,3,0.545455,0.611111,0,0.000446,10 - 14,#75FFF7
506,@saropanap,506,,1,0,1,0.003962,8,8,0,8,0,0,0,0,0.000471, 5 - 9,FALSE
507,@diploparl,507,324,0,4,4,0,12,0,4,4,3,0.517241,0.6,0,0.000446,10 - 14,#75FFF7
508,@srmj1,508,124,0,1,1,0,31,0,1,1,3,0.5,0.537037,0,0.000446,Greater than 30,#FF7575
509,@sravanpvsr,509,538,0,2,2,0,11,0,2,2,4,0.387097,0.465278,0,0.000446,10 - 14,#75FFF7
510,@raaaahluwalia,510,107,0,6,6,0,16,0,6,6,3,0.518519,0.654762,0,0.000446,15 - 19,#75FF79
511,@lsegplc,511,,1,0,1,0.001635,16,1,0,1,0,0,0,0,0.000509,15 - 19,#75FF79
512,@noiweala,512,,1,0,1,0.001635,16,1,0,1,0,0,0,0,0.000509,15 - 19,#75FF79
513,@bankofghana_,513,,1,0,1,0.001635,16,1,0,1,0,0,0,0,0.000509,15 - 19,#75FF79
514,@hmtreasury,514,,1,0,1,0.001635,16,1,0,1,0,0,0,0,0.000509,15 - 19,#75FF79
515,@kbriwashdc,515,16721,3,5,8,0.004906,12,3,35,38,3,0.590909,0.679487,36,0.001017,10 - 14,#75FFF7
516,@b_bowoleksono,516,,4,0,4,0.007506,12,10,0,10,0,0,0,0,0.001191,10 - 14,#75FFF7
517,@am2018bali,517,,1,0,1,0.0026,12,7,0,7,0,0,0,0,0.000619,10 - 14,#75FFF7
518,@ditjen_imigrasi,518,,1,0,1,0.0026,12,7,0,7,0,0,0,0,0.000619,10 - 14,#75FFF7
519,@minfin_ukraine,519,5009,5,2,7,0.008177,31,5,32,37,3,0.526316,0.583333,0,0.001081,Greater than 30,#FF7575
520,@frankheem,520,,10,0,10,0.020803,31,27,0,27,0,0,0,0,0.002248,Greater than 30,#FF7575
521,@theo_morrissey,521,229,0,4,4,0,0,0,4,4,3,0.480769,0.54,0,0.000446,0 - 4,#FF75FF
522,@joselviveropol,522,2141,3,10,13,0.010936,8,31,18,49,4,0.443038,0.489683,0,0.000517, 5 - 9,FALSE
523,@lrlookout,523,,4,0,4,0.014043,8,32,0,32,0,0,0,0,0.000561, 5 - 9,FALSE
524,@farisahmedusc,524,496,3,10,13,0.010936,8,31,18,49,4,0.443038,0.489683,0,0.000517, 5 - 9,FALSE
525,@ferrandotom,525,,4,0,4,0.014043,8,32,0,32,0,0,0,0,0.000561, 5 - 9,FALSE
526,@stefprato,526,,4,0,4,0.014043,8,32,0,32,0,0,0,0,0.000561, 5 - 9,FALSE
527,@foe_us,527,,4,0,4,0.014043,8,32,0,32,0,0,0,0,0.000561, 5 - 9,FALSE
528,@ipesfood,528,,4,0,4,0.014043,8,32,0,32,0,0,0,0,0.000561, 5 - 9,FALSE
529,@panasiapacific,529,,1,0,1,0.003106,8,29,0,29,0,0,0,0,0.000455, 5 - 9,FALSE
530,@pesticideaction,530,,1,0,1,0.003106,8,29,0,29,0,0,0,0,0.000455, 5 - 9,FALSE
531,@tninstitute,531,,1,0,1,0.003106,8,29,0,29,0,0,0,0,0.000455, 5 - 9,FALSE
532,@jjgrodent,532,,1,0,1,0.003106,8,29,0,29,0,0,0,0,0.000455, 5 - 9,FALSE
533,@cncd111111,533,,1,0,1,0.003106,8,29,0,29,0,0,0,0,0.000455, 5 - 9,FALSE
534,@abosife2010,534,1648,0,3,3,0,0,0,4,4,3,0.5625,0.648148,0,0.000446,0 - 4,#FF75FF
535,@ndawnak10,535,31,0,4,4,0,11,0,4,4,3,0.571429,0.652778,0,0.000446,10 - 14,#75FFF7
536,@bill_ams,536,607,0,2,2,0,31,0,2,2,3,0.526316,0.583333,0,0.000446,Greater than 30,#FF7575
537,@amdvasimakram,537,1066,0,2,2,0,31,0,2,2,3,0.526316,0.583333,0,0.000446,Greater than 30,#FF7575
538,@jagratishukla29,538,46752,1,0,1,0.001635,31,1,0,1,0,0,0,0,0.000636,Greater than 30,#FF7575
539,@jhor73,539,1344,0,1,1,0,0,0,1,1,4,0.37931,0.431818,0,0.000446,0 - 4,#FF75FF
540,@red_alertme,540,461,0,2,2,0,17,0,2,2,4,0.387097,0.465278,0,0.000446,15 - 19,#75FF79
541,@yolandekyngdon,541,518,1,3,4,0.001635,17,1,4,5,3,0.55,0.621212,10,0.000636,15 - 19,#75FF79
542,@amdc_amv,542,1569,2,0,2,0.003592,17,3,0,3,0,0,0,0,0.000817,15 - 19,#75FF79
543,@levinsources,543,,1,0,1,0.001957,17,1,0,1,0,0,0,0,0.000627,15 - 19,#75FF79
544,@gce_us,544,3361,7,3,10,0.027835,31,12,13,25,3,0.436364,0.493056,50.166667,0.001296,Greater than 30,#FF7575
545,@theniteshanand,545,186,0,4,4,0,18,0,4,4,3,0.571429,0.652778,0,0.000446,15 - 19,#75FF79
546,@rinkyhundal,546,,1,0,1,0.001635,18,1,0,1,0,0,0,0,0.000541,15 - 19,#75FF79
547,@gurcharandas,547,,1,0,1,0.001635,18,1,0,1,0,0,0,0,0.000541,15 - 19,#75FF79
548,@toiindianews,548,,1,0,1,0.001635,18,1,0,1,0,0,0,0,0.000541,15 - 19,#75FF79
549,@sidurasik222h,549,2493,0,3,3,0,31,0,3,3,3,0.55,0.621212,0,0.000446,Greater than 30,#FF7575
550,@ydcanada,550,2181,3,3,6,0.007126,12,4,15,19,3,0.545455,0.611111,5,0.0008,10 - 14,#75FFF7
551,@fcasvt,551,158,0,1,1,0,31,0,1,1,4,0.357143,0.408333,0,0.000446,Greater than 30,#FF7575
552,@saifullahteuku,552,166,0,2,2,0,12,0,2,2,4,0.4,0.470238,0,0.000446,10 - 14,#75FFF7
553,@felpo09,553,1216,0,2,2,0,0,0,2,2,4,0.392857,0.477273,0,0.000446,0 - 4,#FF75FF
554,@umedmehta45,554,2507,0,3,3,0,11,0,3,3,3,0.545455,0.611111,0,0.000446,10 - 14,#75FFF7
555,@krantipulla,555,328,0,3,3,0,11,0,3,3,3,0.545455,0.611111,0,0.000446,10 - 14,#75FFF7
556,@foynetskiy,556,390,0,3,3,0,31,0,3,3,3,0.55,0.621212,0,0.000446,Greater than 30,#FF7575
557,@prakashpandya7,557,4518,0,5,5,0,11,0,5,5,3,0.565217,0.641026,0,0.000446,10 - 14,#75FFF7
558,@sharat_suave,558,,1,0,1,0.001635,11,1,0,1,0,0,0,0,0.000522,10 - 14,#75FFF7
559,@buzadkathy,559,510,1,13,14,0.00199,31,1,24,25,5,0.412844,0.545185,12.5,0.000655,Greater than 30,#FF7575
560,@schandrashah,560,,1,0,1,0.00199,31,1,0,1,0,0,0,0,0.000489,Greater than 30,#FF7575
561,@wellmonyl,561,,1,0,1,0.00199,31,1,0,1,0,0,0,0,0.000489,Greater than 30,#FF7575
562,@aftunion,562,,1,0,1,0.00199,31,1,0,1,0,0,0,0,0.000489,Greater than 30,#FF7575
563,@rweingarten,563,,1,0,1,0.00199,31,1,0,1,0,0,0,0,0.000489,Greater than 30,#FF7575
564,@marlaucelli,564,,1,0,1,0.00199,31,1,0,1,0,0,0,0,0.000489,Greater than 30,#FF7575
565,@marymac312,565,190,1,2,3,0.00199,31,1,2,3,5,0.357143,0.41,0,0.000489,Greater than 30,#FF7575
566,@gbceducation,566,11546,0,3,3,0,31,0,4,4,3,0.526316,0.583333,0,0.000446,Greater than 30,#FF7575
567,@uncclearn,567,12466,1,2,3,0.001635,31,1,6,7,3,0.529412,0.592593,0.5,0.000573,Greater than 30,#FF7575
568,@alfin_alharas,568,488,0,3,3,0,31,0,3,3,3,0.55,0.621212,0,0.000446,Greater than 30,#FF7575
569,@dakotacyr,569,,1,0,1,0.00199,31,1,0,1,0,0,0,0,0.000489,Greater than 30,#FF7575
570,@jeff_freitas,570,,1,0,1,0.00199,31,1,0,1,0,0,0,0,0.000489,Greater than 30,#FF7575
571,@aftnm,571,,1,0,1,0.00199,31,1,0,1,0,0,0,0,0.000489,Greater than 30,#FF7575
572,@oftadvocate,572,,1,0,1,0.00199,31,1,0,1,0,0,0,0,0.000489,Greater than 30,#FF7575
573,@ope2y,573,2702,0,1,1,0,31,0,1,1,3,0.5,0.537037,0,0.000446,Greater than 30,#FF7575
574,@aapmsu,574,245,1,3,4,0.002384,19,3,4,7,4,0.431818,0.504386,0,0.000514,15 - 19,#75FF79
575,@foodsecuritylab,575,778,2,11,13,0.00441,19,2,60,62,3,0.678571,0.780702,33,0.000874,15 - 19,#75FF79
576,@embulukutu,576,257,2,2,4,0.00441,19,4,2,6,4,0.422222,0.47807,0,0.00066,15 - 19,#75FF79
577,@pim_cgiar,577,1255,3,0,3,0.006793,19,33,0,33,0,0,0,0,0.000942,15 - 19,#75FF79
578,@jayne_thom,578,,1,0,1,0.002384,19,3,0,3,0,0,0,0,0.000514,15 - 19,#75FF79
579,@davetsch,579,,1,0,1,0.002384,19,3,0,3,0,0,0,0,0.000514,15 - 19,#75FF79
580,@ifpri_km,580,,1,0,1,0.002384,19,3,0,3,0,0,0,0,0.000514,15 - 19,#75FF79
581,@agrilinks,581,,1,0,1,0.002384,19,3,0,3,0,0,0,0,0.000514,15 - 19,#75FF79
582,@msuintl,582,,1,0,1,0.002384,19,3,0,3,0,0,0,0,0.000514,15 - 19,#75FF79
583,@gatespoverty,583,,1,0,1,0.002384,19,3,0,3,0,0,0,0,0.000514,15 - 19,#75FF79
584,@peterkerris,584,1999,0,2,2,0,31,0,2,2,5,0.352,0.402273,0,0.000446,Greater than 30,#FF7575
585,@jelmerevers,585,11893,6,12,18,0.010648,31,12,74,86,4,0.477778,0.571705,174,0.001416,Greater than 30,#FF7575
586,@peterkwint,586,,1,0,1,0.00364,31,8,0,8,0,0,0,0,0.000546,Greater than 30,#FF7575
587,@lisawesterveld,587,,1,0,1,0.00364,31,8,0,8,0,0,0,0,0.000546,Greater than 30,#FF7575
588,@vv120907,588,84,0,3,3,0,31,0,3,3,3,0.55,0.621212,0,0.000446,Greater than 30,#FF7575
589,@osmandaqare14,589,4169,0,3,3,0,31,0,3,3,3,0.55,0.621212,0,0.000446,Greater than 30,#FF7575
590,@ndennis_benn,590,3144,0,2,2,0,13,0,2,2,3,0.482759,0.535714,0,0.000446,10 - 14,#75FFF7
591,@joeydelacruz08,591,509,0,2,2,0,0,0,2,2,4,0.378788,0.423333,0,0.000446,0 - 4,#FF75FF
592,@con_rochford,592,2678,0,4,4,0,20,0,4,4,3,0.571429,0.652778,0,0.000446,20 - 24,#E4FF75
593,@devisridhar,593,8535,1,3,4,0.001635,20,1,12,13,3,0.55,0.621212,0,0.000541,20 - 24,#E4FF75
594,@globalhealthgp,594,,2,0,2,0.003592,20,5,0,5,0,0,0,0,0.000695,20 - 24,#E4FF75
595,@respireglobal,595,,2,0,2,0.003592,20,5,0,5,0,0,0,0,0.000695,20 - 24,#E4FF75
596,@corporateeurope,596,,1,0,1,0.003106,8,1,0,1,0,0,0,0,0.000455, 5 - 9,FALSE
597,@truthout,597,,1,0,1,0.003106,8,1,0,1,0,0,0,0,0.000455, 5 - 9,FALSE
598,@naomiaklein,598,,1,0,1,0.003106,8,1,0,1,0,0,0,0,0.000455, 5 - 9,FALSE
599,@popresistance,599,,1,0,1,0.003106,8,1,0,1,0,0,0,0,0.000455, 5 - 9,FALSE
600,@democracynow,600,,1,0,1,0.003106,8,1,0,1,0,0,0,0,0.000455, 5 - 9,FALSE
601,@roar_magazine,601,,1,0,1,0.003106,8,1,0,1,0,0,0,0,0.000455, 5 - 9,FALSE
602,@ips_dc,602,,1,0,1,0.003106,8,1,0,1,0,0,0,0,0.000455, 5 - 9,FALSE
603,@inequalityorg,603,,1,0,1,0.003106,8,1,0,1,0,0,0,0,0.000455, 5 - 9,FALSE
604,@landrightsnow,604,,2,0,2,0.005697,8,2,0,2,0,0,0,0,0.000468, 5 - 9,FALSE
605,@omparkashdahiya,605,4033,0,3,3,0,11,0,3,3,3,0.545455,0.611111,0,0.000446,10 - 14,#75FFF7
606,@farhanali0605,606,80,0,2,2,0,12,0,2,2,4,0.4,0.470238,0,0.000446,10 - 14,#75FFF7
607,@jennrigg,607,1357,1,9,10,0.001635,31,1,14,15,3,0.577778,0.647436,0.5,0.000488,Greater than 30,#FF7575
608,@iptradingrisk,608,934,0,1,1,0,31,0,1,1,3,0.5,0.537037,0,0.000446,Greater than 30,#FF7575
609,@cwretirement,609,508,0,1,1,0,31,0,1,1,3,0.5,0.537037,0,0.000446,Greater than 30,#FF7575
610,@mollymutanu,610,158,0,8,8,0,2,0,8,8,3,0.53125,0.656863,0,0.000446,0 - 4,#FF75FF
611,@nigeriawhatsnew,611,2630,0,1,1,0,31,0,1,1,3,0.5,0.537037,0,0.000446,Greater than 30,#FF7575
612,@chapoyc,612,56,0,3,3,0,21,0,3,3,3,0.545455,0.611111,0,0.000446,20 - 24,#E4FF75
613,@nlintheusa,613,38414,1,3,4,0.001635,21,1,9,10,3,0.55,0.621212,1,0.000573,20 - 24,#E4FF75
614,@raymondknops,614,,2,0,2,0.003592,21,4,0,4,0,0,0,0,0.000736,20 - 24,#E4FF75
615,@wbcaribbean,615,,1,0,1,0.001957,21,3,0,3,0,0,0,0,0.000609,20 - 24,#E4FF75
616,@abaruleoflaw,616,1746,0,6,6,0,22,0,6,6,3,0.608696,0.702381,0,0.000446,20 - 24,#E4FF75
617,@nikidasarathy,617,,1,0,1,0.001635,22,1,0,1,0,0,0,0,0.000509,20 - 24,#E4FF75
618,@dgrisgraber,618,,1,0,1,0.001635,22,1,0,1,0,0,0,0,0.000509,20 - 24,#E4FF75
619,@refugeesintl,619,,1,0,1,0.001635,22,1,0,1,0,0,0,0,0.000509,20 - 24,#E4FF75
620,@pprettitore,620,,1,0,1,0.001635,22,1,0,1,0,0,0,0,0.000509,20 - 24,#E4FF75
621,@hmnrghtsprogram,621,,1,0,1,0.001635,22,1,0,1,0,0,0,0,0.000509,20 - 24,#E4FF75
622,@sumitkashyap22,622,379,0,3,3,0,11,0,3,3,3,0.545455,0.611111,0,0.000446,10 - 14,#75FFF7
623,@jhlowther,623,438,0,1,1,0,31,0,1,1,3,0.5,0.537037,0,0.000446,Greater than 30,#FF7575
624,@olu_jay,624,357,0,3,3,0,31,0,3,3,3,0.545455,0.611111,0,0.000446,Greater than 30,#FF7575
625,@connect4climate,625,168624,6,2,8,0.009812,31,6,14,20,3,0.526316,0.583333,51,0.002478,Greater than 30,#FF7575
626,@convergencebf,626,556,0,3,3,0,0,0,3,3,3,0.458333,0.560606,0,0.000446,0 - 4,#FF75FF
627,@txfmedia,627,,1,0,1,0.001635,0,1,0,1,0,0,0,0,0.000573,0 - 4,#FF75FF
628,@mccgov,628,,1,0,1,0.001635,0,1,0,1,0,0,0,0,0.000573,0 - 4,#FF75FF
629,@farabandiak,629,465,0,1,1,0,31,0,1,1,3,0.5,0.537037,0,0.000446,Greater than 30,#FF7575
630,@bgipu,630,2227,0,5,5,0,12,0,5,5,3,0.576923,0.655556,0,0.000446,10 - 14,#75FFF7
631,@iljaklink,631,3674,0,2,2,0,31,0,2,2,5,0.352,0.402273,0,0.000446,Greater than 30,#FF7575
632,@cities_today,632,17842,0,3,3,0,23,0,3,3,3,0.545455,0.611111,0,0.000446,20 - 24,#E4FF75
633,@wuf9kl2018,633,,1,0,1,0.001635,23,1,0,1,0,0,0,0,0.000573,20 - 24,#E4FF75
634,@wb_research,634,47250,2,2,4,0.003271,23,2,2,4,3,0.526316,0.583333,11,0.000954,20 - 24,#E4FF75
635,@acpypn,635,1294,2,4,6,0.003271,24,2,12,14,3,0.571429,0.652778,24,0.001208,20 - 24,#E4FF75
636,@mcnhlapo,636,,1,0,1,0.002279,24,3,0,3,0,0,0,0,0.000703,20 - 24,#E4FF75
637,@commonwealth18,637,,1,0,1,0.002279,24,3,0,3,0,0,0,0,0.000703,20 - 24,#E4FF75
638,@pressacp,638,,1,0,1,0.002279,24,3,0,3,0,0,0,0,0.000703,20 - 24,#E4FF75
639,@allcorgis,639,626,0,3,3,0,9,0,3,3,4,0.421053,0.505208,0,0.000446, 5 - 9,FALSE
640,@gerbaron,640,6072,2,2,4,0.005276,31,2,6,8,5,0.328244,0.37093,0,0.000673,Greater than 30,#FF7575
641,@yentyl_w,641,1595,0,1,1,0,24,0,1,1,4,0.382353,0.429487,0,0.000446,20 - 24,#E4FF75
642,@voiceswife,642,358,0,3,3,0,25,0,4,4,1,1,1,0,0.000446,25 - 29,#FFB175
643,@smrth2osmrtcty,643,481,1,2,3,0.001635,25,1,4,5,1,1,1,0,0.000573,25 - 29,#FFB175
644,@africautcnow,644,,2,0,2,0.003592,25,3,0,3,0,0,0,0,0.000817,25 - 29,#FFB175
645,@africautilities,645,3517,2,0,2,0.003592,25,4,0,4,0,0,0,0,0.000817,25 - 29,#FFB175
646,@nefyodov,646,4410,0,3,3,0,31,0,3,3,3,0.55,0.621212,0,0.000446,Greater than 30,#FF7575
647,@mishrapreetu,647,354,0,1,1,0,26,0,1,1,4,0.404762,0.446078,0,0.000446,25 - 29,#FFB175
648,@shantan63070103,648,34,1,8,9,0.001635,26,1,8,9,3,0.64,0.739583,16,0.000827,25 - 29,#FFB175
649,@mamtahimc,649,,1,0,1,0.001957,26,1,0,1,0,0,0,0,0.000534,25 - 29,#FFB175
650,@mohfw_india,650,,1,0,1,0.001957,26,1,0,1,0,0,0,0,0.000534,25 - 29,#FFB175
651,@ministrywcd,651,,1,0,1,0.001957,26,1,0,1,0,0,0,0,0.000534,25 - 29,#FFB175
652,@hemocueab,652,,1,0,1,0.001957,26,1,0,1,0,0,0,0,0.000534,25 - 29,#FFB175
653,@nhpindia,653,,1,0,1,0.001957,26,1,0,1,0,0,0,0,0.000534,25 - 29,#FFB175
654,@poshanabhiyaan,654,,1,0,1,0.001957,26,1,0,1,0,0,0,0,0.000534,25 - 29,#FFB175
655,@poshansm,655,,1,0,1,0.001957,26,1,0,1,0,0,0,0,0.000534,25 - 29,#FFB175
656,@oumavictor_,656,200,0,5,5,0,29,0,5,5,3,0.566667,0.637255,0,0.000446,25 - 29,#FFB175
657,@janes_owuor,657,183,1,4,5,0.001635,29,1,20,21,3,0.551724,0.614583,0,0.000522,25 - 29,#FFB175
658,@maryhelda,658,,2,0,2,0.003592,29,6,0,6,0,0,0,0,0.000633,25 - 29,#FFB175
659,@benazirmoha,659,,2,0,2,0.003592,29,6,0,6,0,0,0,0,0.000633,25 - 29,#FFB175
660,@eapcsf,660,1721,1,1,2,0.001635,31,1,3,4,3,0.5,0.537037,9,0.000827,Greater than 30,#FF7575
661,@kachrooogra,661,193,0,3,3,0,31,0,3,3,3,0.55,0.621212,0,0.000446,Greater than 30,#FF7575
662,@nadinefernz,662,229,0,4,4,0,27,0,4,4,3,0.565217,0.641026,0,0.000446,25 - 29,#FFB175
663,@granickas,663,499,1,4,5,0.001635,27,1,16,17,3,0.571429,0.652778,1,0.000541,25 - 29,#FFB175
664,@ogp_anticorrptn,664,,2,0,2,0.003592,27,5,0,5,0,0,0,0,0.000657,25 - 29,#FFB175
665,@costransparency,665,,2,0,2,0.003592,27,5,0,5,0,0,0,0,0.000657,25 - 29,#FFB175
666,@gavinhayman_gw,666,,1,0,1,0.001957,27,4,0,4,0,0,0,0,0.000561,25 - 29,#FFB175
667,@artist_diplomat,667,2282,0,2,2,0,31,0,2,2,3,0.526316,0.583333,0,0.000446,Greater than 30,#FF7575
668,@smartergrid_,668,26,0,1,1,0,5,0,1,1,4,0.366667,0.416667,0,0.000446, 5 - 9,FALSE
669,@irena,669,,1,0,1,0.00319,5,1,0,1,0,0,0,0,0.000951, 5 - 9,FALSE
670,@stevenklees,670,,1,0,1,0.006149,31,3,0,3,0,0,0,0,0.000559,Greater than 30,#FF7575
671,@jiasociety,671,1166,0,2,2,0,31,0,2,2,3,0.526316,0.583333,0,0.000446,Greater than 30,#FF7575
672,@amfar,672,,1,0,1,0.001635,31,1,0,1,0,0,0,0,0.000636,Greater than 30,#FF7575
673,@patdalto,673,1590,0,1,1,0,0,0,1,1,4,0.37931,0.431818,0,0.000446,0 - 4,#FF75FF
674,@martschoonhoven,674,342,0,3,3,0,31,0,4,4,5,0.333333,0.385227,0,0.000446,Greater than 30,#FF7575
675,@bitnoscam,675,5534,0,2,2,0,31,0,2,2,3,0.52381,0.575758,0,0.000446,Greater than 30,#FF7575
676,@jcstorozuk,676,85,0,2,2,0,12,0,2,2,3,0.5,0.551282,0,0.000446,10 - 14,#75FFF7
677,@khairudintassme,677,17,0,2,2,0,31,0,2,2,3,0.526316,0.583333,0,0.000446,Greater than 30,#FF7575
678,@gwpsaf,678,798,0,1,1,0,31,0,1,1,4,0.357143,0.408333,0,0.000446,Greater than 30,#FF7575
679,@strategyand,679,88151,0,1,1,0,15,0,1,1,4,0.357143,0.408333,0,0.000446,15 - 19,#75FF79
680,@indoethio,680,2831,0,2,2,0,12,0,2,2,4,0.4,0.470238,0,0.000446,10 - 14,#75FFF7
681,@michelleyrose1,681,22,0,1,1,0,31,0,1,1,4,0.357143,0.408333,0,0.000446,Greater than 30,#FF7575
682,@sur_del,682,52,0,1,1,0,31,0,1,1,3,0.5,0.537037,0,0.000446,Greater than 30,#FF7575
683,@cier2018tomas,683,144,0,1,1,0,31,0,1,1,4,0.357143,0.408333,0,0.000446,Greater than 30,#FF7575
684,@mililechleiter,684,,2,0,2,0.003592,0,2,0,2,0,0,0,0,0.000534,0 - 4,#FF75FF
685,@deliliah269,685,158,0,3,3,0,8,0,3,3,4,0.316418,0.35456,0,0.000446, 5 - 9,FALSE
686,@argadhaggeti,686,4973,0,3,3,0,8,0,3,3,4,0.324159,0.366352,0,0.000446, 5 - 9,FALSE
687,@ghsaghin,687,197,0,2,2,0,31,0,2,2,3,0.526316,0.583333,0,0.000446,Greater than 30,#FF7575
688,@igiridr,688,389,0,3,3,0,31,0,3,3,3,0.529412,0.592593,0,0.000446,Greater than 30,#FF7575
689,@subhank25219819,689,266,0,3,3,0,11,0,3,3,3,0.545455,0.611111,0,0.000446,10 - 14,#75FFF7
690,@1971mtp,690,7218,0,2,2,0,31,0,2,2,3,0.52381,0.575758,0,0.000446,Greater than 30,#FF7575
691,@iamaniku,691,1029,0,1,1,0,31,0,1,1,3,0.5,0.537037,0,0.000446,Greater than 30,#FF7575
692,@tgarciaazcarate,692,2500,0,1,1,0,31,0,1,1,4,0.357143,0.408333,0,0.000446,Greater than 30,#FF7575
693,@tonyelumelufdn,693,270265,18,5,23,0.029757,29,22,165,187,3,0.6,0.694444,180,0.003579,25 - 29,#FFB175
694,@tonyoelumelu,694,,16,0,16,0.031987,29,49,0,49,0,0,0,0,0.003818,25 - 29,#FFB175
695,@linkedin,695,,1,0,1,0.007457,29,33,0,33,0,0,0,0,0.001056,25 - 29,#FFB175
696,@jeffweiner,696,,1,0,1,0.007457,29,33,0,33,0,0,0,0,0.001056,25 - 29,#FFB175
697,@ufukuar90500874,697,154,0,1,1,0,31,0,1,1,3,0.5,0.537037,0,0.000446,Greater than 30,#FF7575
698,@g0tthememo,698,27,0,1,1,0,31,0,1,1,3,0.5,0.537037,0,0.000446,Greater than 30,#FF7575
699,@wbg_ppp,699,38548,4,2,6,0.009498,31,8,50,58,3,0.526316,0.583333,0,0.001527,Greater than 30,#FF7575
700,@hartwigschafer,700,2087,5,2,7,0.011488,31,32,4,36,3,0.526316,0.583333,3,0.001738,Greater than 30,#FF7575
701,@mohdfar35377035,701,169,0,3,3,0,31,0,3,3,3,0.55,0.621212,0,0.000446,Greater than 30,#FF7575
702,@amerix,702,12558,0,2,2,0,29,0,2,2,4,0.40625,0.480769,0,0.000446,25 - 29,#FFB175
703,@frank_kay3,703,808,0,1,1,0,31,0,1,1,3,0.5,0.537037,0,0.000446,Greater than 30,#FF7575
704,@opolotakwang,704,187,0,1,1,0,31,0,1,1,3,0.5,0.537037,0,0.000446,Greater than 30,#FF7575
705,@codengo,705,1754,0,2,2,0,31,0,2,2,3,0.526316,0.583333,0,0.000446,Greater than 30,#FF7575
706,@manuchomuchacho,706,158,0,4,4,0,0,0,4,4,3,0.571429,0.652778,0,0.000446,0 - 4,#FF75FF
707,@icorreccion,707,,1,0,1,0.001635,0,1,0,1,0,0,0,0,0.000541,0 - 4,#FF75FF
708,@mnarbs,708,243,0,2,2,0,31,0,2,2,3,0.52381,0.575758,0,0.000446,Greater than 30,#FF7575
709,@unops,709,35055,2,2,4,0.003592,31,2,4,6,3,0.526316,0.583333,3,0.000989,Greater than 30,#FF7575
710,@worldbankmena,710,,1,0,1,0.00231,31,2,0,2,0,0,0,0,0.000868,Greater than 30,#FF7575
711,@heirs_holdings,711,45503,0,2,2,0,29,0,2,2,4,0.40625,0.480769,0,0.000446,25 - 29,#FFB175
712,@sachin_chat,712,2531,1,5,6,0.001635,31,1,8,9,3,0.571429,0.652778,0,0.000522,Greater than 30,#FF7575
713,@rtandon_pria,713,,2,0,2,0.003592,31,2,0,2,0,0,0,0,0.000611,Greater than 30,#FF7575
714,@gsachdevajnu,714,,2,0,2,0.003592,31,2,0,2,0,0,0,0,0.000611,Greater than 30,#FF7575
715,@thomaspogge,715,,2,0,2,0.003592,31,2,0,2,0,0,0,0,0.000611,Greater than 30,#FF7575
716,@carlamontesi,716,1311,0,3,3,0,12,0,3,3,3,0.55,0.621212,0,0.000446,10 - 14,#75FFF7
717,@andersjagerskog,717,1057,0,1,1,0,31,0,1,1,4,0.357143,0.408333,0,0.000446,Greater than 30,#FF7575
718,@onubibuv,718,121,0,2,2,0,31,0,2,2,3,0.526316,0.583333,0,0.000446,Greater than 30,#FF7575
719,@quinoa_man,719,57,0,2,2,0,31,0,2,2,3,0.5,0.537037,0,0.000446,Greater than 30,#FF7575
720,@elizabetgomez16,720,130,0,2,2,0,0,0,2,2,4,0.392857,0.477273,0,0.000446,0 - 4,#FF75FF
721,@semilladlpueblo,721,,1,0,1,0.003106,8,1,0,1,0,0,0,0,0.000455, 5 - 9,FALSE
722,@ustierra,722,,1,0,1,0.003106,8,1,0,1,0,0,0,0,0.000455, 5 - 9,FALSE
723,@mst_oficial,723,,1,0,1,0.003106,8,1,0,1,0,0,0,0,0.000455, 5 - 9,FALSE
724,@murphyeagle,724,550,1,5,6,0.003106,8,1,7,8,4,0.327103,0.376984,0.75,0.000455, 5 - 9,FALSE
725,@pidhdd,725,,1,0,1,0.003106,8,1,0,1,0,0,0,0,0.000455, 5 - 9,FALSE
726,@prosalus,726,,1,0,1,0.003106,8,1,0,1,0,0,0,0,0.000455, 5 - 9,FALSE
727,@jpaskalina,727,276,0,1,1,0,24,0,1,1,4,0.382353,0.429487,0,0.000446,20 - 24,#E4FF75
728,@janinebranch00,728,50,0,3,3,0,31,0,3,3,3,0.55,0.621212,0,0.000446,Greater than 30,#FF7575
729,@csis_usld,729,3581,2,2,4,0.003981,33,4,2,6,3,0.52381,0.575758,8.5,0.000705,Greater than 30,#FF7575
730,@45956888,730,440,0,3,3,0,31,0,3,3,3,0.55,0.621212,0,0.000446,Greater than 30,#FF7575
731,@sabre2001,731,1392,0,1,1,0,5,0,1,1,4,0.388889,0.434524,0,0.000446, 5 - 9,FALSE
732,@_icrp_,732,167,1,5,6,0.001635,5,1,5,6,3,0.590909,0.679487,13,0.000827, 5 - 9,FALSE
733,@hrw,733,,1,0,1,0.001957,5,1,0,1,0,0,0,0,0.000587, 5 - 9,FALSE
734,@amnesty,734,,1,0,1,0.001957,5,1,0,1,0,0,0,0,0.000587, 5 - 9,FALSE
735,@segalink,735,,1,0,1,0.001957,5,1,0,1,0,0,0,0,0.000587, 5 - 9,FALSE
736,@sabdara123,736,133,0,2,2,0,29,0,2,2,4,0.40625,0.480769,0,0.000446,25 - 29,#FFB175
737,@saidahdoune2,737,193,0,2,2,0,29,0,2,2,3,0.529412,0.592593,0,0.000446,25 - 29,#FFB175
738,@sfanonline,738,935,1,2,3,0.001635,29,1,6,7,4,0.411765,0.482143,0,0.000573,25 - 29,#FFB175
739,@welti_ng,739,92,0,3,3,0,31,0,3,3,3,0.55,0.621212,0,0.000446,Greater than 30,#FF7575
740,@fenyig7,740,358,0,3,3,0,29,0,4,4,4,0.428571,0.516667,0,0.000446,25 - 29,#FFB175
741,@sabaloftus,741,2431,1,3,4,0.001635,31,1,4,5,3,0.53125,0.578431,1,0.00048,Greater than 30,#FF7575
742,@nditu1,742,1135,0,8,8,0,31,0,17,17,3,0.536585,0.583333,0,0.000446,Greater than 30,#FF7575
743,@natberkicau,743,67,0,2,2,0,31,0,3,3,3,0.526316,0.583333,0,0.000446,Greater than 30,#FF7575
744,@dmiliband,744,254497,1,2,3,0.002676,31,6,2,8,4,0.425,0.485294,0,0.00053,Greater than 30,#FF7575
745,@cgdev,745,,4,0,4,0.008422,31,9,0,9,0,0,0,0,0.001174,Greater than 30,#FF7575
746,@theirc,746,,1,0,1,0.002676,31,6,0,6,0,0,0,0,0.00053,Greater than 30,#FF7575
747,@nancymbirdsall,747,29300,1,2,3,0.002676,31,6,2,8,4,0.425,0.485294,0,0.00053,Greater than 30,#FF7575
748,@mopic_jordan,748,,1,0,1,0.002676,31,6,0,6,0,0,0,0,0.00053,Greater than 30,#FF7575
749,@cookstoves,749,10456,1,1,2,0.001635,31,1,2,3,3,0.5,0.537037,0,0.000573,Greater than 30,#FF7575
750,@roofy_suxido1,750,270,0,2,2,0,28,0,2,2,4,0.410256,0.473958,0,0.000446,25 - 29,#FFB175
751,@jani4tijani,751,1683,4,11,15,0.007445,28,12,26,38,3,0.625,0.722222,32,0.001006,25 - 29,#FFB175
752,@imflive,752,,4,0,4,0.010177,28,14,0,14,0,0,0,0,0.000703,25 - 29,#FFB175
753,@mofiobafemi,753,5940,3,0,3,0.006272,28,10,0,10,0,0,0,0,0.000905,25 - 29,#FFB175
754,@mbuhari,754,,4,0,4,0.010177,28,14,0,14,0,0,0,0,0.000703,25 - 29,#FFB175
755,@azizsyamsuddin,755,,1,0,1,0.00352,12,4,0,4,0,0,0,0,0.000678,10 - 14,#75FFF7
756,@gabycuevas,756,,1,0,1,0.00352,12,4,0,4,0,0,0,0,0.000678,10 - 14,#75FFF7
757,@dianeravitch,757,,2,0,2,0.005276,31,5,0,5,0,0,0,0,0.000594,Greater than 30,#FF7575
758,@hstevenson10,758,,1,0,1,0.00364,31,4,0,4,0,0,0,0,0.000546,Greater than 30,#FF7575
759,@pasi_sahlberg,759,,1,0,1,0.00364,31,4,0,4,0,0,0,0,0.000546,Greater than 30,#FF7575
760,@dsinyolo,760,,1,0,1,0.00364,31,2,0,2,0,0,0,0,0.000546,Greater than 30,#FF7575
761,@lasmagazines,761,39929,0,1,1,0,31,0,1,1,3,0.5,0.537037,0,0.000446,Greater than 30,#FF7575
762,@yeyeolade,762,46,0,2,2,0,29,0,2,2,4,0.40625,0.480769,0,0.000446,25 - 29,#FFB175
763,@adajeobiabosund,763,754,0,2,2,0,29,0,2,2,4,0.40625,0.480769,0,0.000446,25 - 29,#FFB175
764,@benphillips76,764,16134,1,0,1,0.001957,29,8,0,8,0,0,0,0,0.000547,25 - 29,#FFB175
765,@ppiaf_ppp,765,3781,0,3,3,0,31,0,12,12,3,0.55,0.621212,0,0.000446,Greater than 30,#FF7575
766,@emtzfranco,766,90,0,1,1,0,31,0,1,1,3,0.5,0.537037,0,0.000446,Greater than 30,#FF7575
767,@0818ee50013043c,767,274,0,20,20,0,36,0,20,20,3,0.756757,0.85119,0,0.000446,Greater than 30,#FF7575
768,@lingayatadharma,768,,1,0,1,0.001635,36,1,0,1,0,0,0,0,0.000465,Greater than 30,#FF7575
769,@ilyfglobal,769,,1,0,1,0.001635,36,1,0,1,0,0,0,0,0.000465,Greater than 30,#FF7575
770,@basavasamithi,770,,1,0,1,0.001635,36,1,0,1,0,0,0,0,0.000465,Greater than 30,#FF7575
771,@reachmbp,771,,1,0,1,0.001635,36,1,0,1,0,0,0,0,0.000465,Greater than 30,#FF7575
772,@vachanasanchaya,772,,1,0,1,0.001635,36,1,0,1,0,0,0,0,0.000465,Greater than 30,#FF7575
773,@bbcnewsasia,773,,1,0,1,0.001635,36,1,0,1,0,0,0,0,0.000465,Greater than 30,#FF7575
774,@bbc,774,,1,0,1,0.001635,36,1,0,1,0,0,0,0,0.000465,Greater than 30,#FF7575
775,@bbcmediaaction,775,,1,0,1,0.001635,36,1,0,1,0,0,0,0,0.000465,Greater than 30,#FF7575
776,@indiatoday,776,,1,0,1,0.001635,36,1,0,1,0,0,0,0,0.000465,Greater than 30,#FF7575
777,@indiatodayflash,777,,1,0,1,0.001635,36,1,0,1,0,0,0,0,0.000465,Greater than 30,#FF7575
778,@indiatodaytech,778,,1,0,1,0.001635,36,1,0,1,0,0,0,0,0.000465,Greater than 30,#FF7575
779,@indiaedumart,779,,1,0,1,0.001635,36,1,0,1,0,0,0,0,0.000465,Greater than 30,#FF7575
780,@rashtrapatibhvn,780,,1,0,1,0.001635,36,1,0,1,0,0,0,0,0.000465,Greater than 30,#FF7575
781,@pti_news,781,,1,0,1,0.001635,36,1,0,1,0,0,0,0,0.000465,Greater than 30,#FF7575
782,@tweetpollindia,782,,1,0,1,0.001635,36,1,0,1,0,0,0,0,0.000465,Greater than 30,#FF7575
783,@airnewsalerts,783,,1,0,1,0.001635,36,1,0,1,0,0,0,0,0.000465,Greater than 30,#FF7575
784,@world,784,,1,0,1,0.001635,36,1,0,1,0,0,0,0,0.000465,Greater than 30,#FF7575
785,@karnatakaworld,785,,1,0,1,0.001635,36,1,0,1,0,0,0,0,0.000465,Greater than 30,#FF7575
786,@joscchh,786,1714,6,9,15,0.012764,31,6,20,26,3,0.625,0.722222,27,0.001478,Greater than 30,#FF7575
787,@cif_action,787,12572,3,1,4,0.007099,31,3,2,5,3,0.5,0.537037,9,0.001002,Greater than 30,#FF7575
788,@fknopjes,788,133,0,2,2,0,12,0,2,2,4,0.393939,0.467949,0,0.000446,10 - 14,#75FFF7
789,@nkarachiwalla,789,53,0,1,1,0,31,0,1,1,4,0.375,0.423611,0,0.000446,Greater than 30,#FF7575
790,@epodharvard,790,6436,1,3,4,0.001635,31,1,3,4,3,0.55,0.621212,11,0.000827,Greater than 30,#FF7575
791,@theeconomist,791,,1,0,1,0.001957,31,1,0,1,0,0,0,0,0.000681,Greater than 30,#FF7575
792,@wbg_splabor,792,2871,1,1,2,0.001957,31,1,1,2,3,0.5,0.537037,0,0.000681,Greater than 30,#FF7575
793,@jpsgeriatrician,793,9,0,4,4,0,11,0,4,4,3,0.571429,0.652778,0,0.000446,10 - 14,#75FFF7
794,@koarrumm,794,708,0,1,1,0,31,0,1,1,3,0.5,0.537037,0,0.000446,Greater than 30,#FF7575
795,@stevenahunt,795,1078,0,4,4,0,5,0,4,4,3,0.531915,0.573333,0,0.000446, 5 - 9,FALSE
796,@tradomglobal,796,1842,0,1,1,0,31,0,1,1,4,0.357143,0.408333,0,0.000446,Greater than 30,#FF7575
797,@devfinobserver,797,5,0,2,2,0,31,0,2,2,3,0.526316,0.583333,0,0.000446,Greater than 30,#FF7575
798,@pmwbxl,798,1823,0,1,1,0,31,0,1,1,4,0.357143,0.408333,0,0.000446,Greater than 30,#FF7575
799,@doraperu,799,304,0,2,2,0,31,0,4,4,3,0.52381,0.575758,0,0.000446,Greater than 30,#FF7575
800,@ua_minfin,800,125,0,2,2,0,31,0,2,2,3,0.526316,0.583333,0,0.000446,Greater than 30,#FF7575
801,@malackabir,801,9,0,2,2,0,31,0,3,3,3,0.526316,0.583333,0,0.000446,Greater than 30,#FF7575
802,@worldbanklive,802,130139,1,2,3,0.001635,31,2,4,6,3,0.529412,0.592593,0.5,0.000636,Greater than 30,#FF7575
803,@aynigga,803,1294,0,1,1,0,31,0,1,1,3,0.5,0.537037,0,0.000446,Greater than 30,#FF7575
804,@hubsnigeria,804,99,0,2,2,0,29,0,2,2,4,0.40625,0.480769,0,0.000446,25 - 29,#FFB175
805,@craighammer,805,1067,0,1,1,0,31,0,1,1,3,0.5,0.537037,0,0.000446,Greater than 30,#FF7575
806,@mighty_futures,806,45,0,2,2,0,31,0,2,2,3,0.526316,0.583333,0,0.000446,Greater than 30,#FF7575
807,@ursh93,807,253,0,2,2,0,31,0,2,2,3,0.526316,0.583333,0,0.000446,Greater than 30,#FF7575
808,@money_bhaskar,808,4084,2,1,3,0.003271,31,2,2,4,3,0.5,0.537037,0,0.000827,Greater than 30,#FF7575
809,@ogwaljos,809,275,0,2,2,0,29,0,2,2,4,0.40625,0.480769,0,0.000446,25 - 29,#FFB175
810,@periodistafredy,810,3011,0,2,2,0,0,0,2,2,4,0.392857,0.477273,0,0.000446,0 - 4,#FF75FF
811,@simonhernandez,811,1396,0,1,1,0,31,0,1,1,3,0.5,0.537037,0,0.000446,Greater than 30,#FF7575
812,@bicherita,812,684,0,1,1,0,0,0,1,1,4,0.37931,0.431818,0,0.000446,0 - 4,#FF75FF
813,@lukawanjohi,813,600,0,1,1,0,31,0,1,1,3,0.5,0.537037,0,0.000446,Greater than 30,#FF7575
814,@whoyemen,814,117665,6,1,7,0.009812,31,10,11,21,3,0.5,0.537037,0,0.001303,Greater than 30,#FF7575
815,@bbatwooki,815,3893,0,4,4,0,29,0,6,6,4,0.424242,0.517857,0,0.000446,25 - 29,#FFB175
816,@imaraafr,816,,1,0,1,0.001635,29,1,0,1,0,0,0,0,0.000541,25 - 29,#FFB175
817,@bankxrp,817,5552,0,3,3,0,29,0,3,3,3,0.555556,0.633333,0,0.000446,25 - 29,#FFB175
818,@umdcollegeofed,818,,1,0,1,0.006149,31,3,0,3,0,0,0,0,0.000559,Greater than 30,#FF7575
819,@afsafrica,819,,1,0,1,0.003962,8,11,0,11,0,0,0,0,0.000471, 5 - 9,FALSE
820,@ahssolarcougars,820,105,0,2,2,0,31,0,2,2,3,0.526316,0.583333,0,0.000446,Greater than 30,#FF7575
821,@bigshiftglobal,821,215,2,1,3,0.003271,31,2,4,6,3,0.5,0.537037,0,0.000827,Greater than 30,#FF7575
822,@_devendraswaraj,822,90,0,3,3,0,11,0,4,4,4,0.40625,0.50641,0,0.000446,10 - 14,#75FFF7
823,@rajamujeeb,823,239,1,2,3,0.001635,11,1,4,5,4,0.387097,0.465278,0,0.000573,10 - 14,#75FFF7
824,@girlshealthed,824,1416,0,7,7,0,13,0,8,8,3,0.592593,0.677083,0,0.000446,10 - 14,#75FFF7
825,@sendacow,825,,1,0,1,0.001635,13,1,0,1,0,0,0,0,0.0005,10 - 14,#75FFF7
826,@_moyoa,826,1351,0,2,2,0,29,0,2,2,4,0.40625,0.480769,0,0.000446,25 - 29,#FFB175
827,@ifpc15,827,271,0,4,4,0,0,0,4,4,3,0.480769,0.54,0,0.000446,0 - 4,#FF75FF
828,@rogersmulwa1,828,211,0,3,3,0,29,0,3,3,3,0.555556,0.633333,0,0.000446,25 - 29,#FFB175
829,@manglashubham94,829,161,0,3,3,0,29,0,3,3,3,0.555556,0.633333,0,0.000446,25 - 29,#FFB175
830,@magali23_magali,830,221,0,1,1,0,31,0,13,13,3,0.5,0.537037,0,0.000446,Greater than 30,#FF7575
831,@_biancasantos9,831,107,0,2,2,0,31,0,2,2,3,0.526316,0.583333,0,0.000446,Greater than 30,#FF7575
832,@lifenstein,832,274,0,2,2,0,31,0,2,2,3,0.526316,0.583333,0,0.000446,Greater than 30,#FF7575
833,@bonniekoenig,833,3391,0,1,1,0,31,0,1,1,3,0.5,0.537037,0,0.000446,Greater than 30,#FF7575
834,@nwnancy,834,1137,0,5,5,0,31,0,8,8,3,0.576923,0.655556,0,0.000446,Greater than 30,#FF7575
835,@tshitok,835,800,0,1,1,0,1,0,1,1,4,0.357143,0.408333,0,0.000446,0 - 4,#FF75FF
836,@rteinitiative,836,2533,0,4,4,0,0,0,4,4,3,0.480769,0.54,0,0.000446,0 - 4,#FF75FF
837,@mainawangooro,837,93,0,2,2,0,31,0,2,2,3,0.526316,0.583333,0,0.000446,Greater than 30,#FF7575
838,@1africa1love,838,1036,0,6,6,0,8,0,10,10,4,0.403042,0.439465,0,0.000446, 5 - 9,FALSE
839,@lesliekofoed,839,1905,0,2,2,0,31,0,2,2,3,0.526316,0.583333,0,0.000446,Greater than 30,#FF7575
840,@youtheconopps,840,3260,0,1,1,0,31,0,1,1,3,0.5,0.537037,0,0.000446,Greater than 30,#FF7575
841,@limidush13,841,157,0,2,2,0,31,0,2,2,3,0.526316,0.583333,0,0.000446,Greater than 30,#FF7575
842,@gjep123,842,,1,0,1,0.002591,8,1,0,1,0,0,0,0,0.000459, 5 - 9,FALSE
843,@fernnews,843,,1,0,1,0.002591,8,1,0,1,0,0,0,0,0.000459, 5 - 9,FALSE
844,@teebagrifood,844,,1,0,1,0.002591,8,1,0,1,0,0,0,0,0.000459, 5 - 9,FALSE
845,@poleconet,845,,1,0,1,0.002591,8,1,0,1,0,0,0,0,0.000459, 5 - 9,FALSE
846,@tri_continental,846,,1,0,1,0.002591,8,1,0,1,0,0,0,0,0.000459, 5 - 9,FALSE
847,@biceuro,847,,1,0,1,0.002591,8,1,0,1,0,0,0,0,0.000459, 5 - 9,FALSE
848,@globalnamati,848,,1,0,1,0.002591,8,1,0,1,0,0,0,0,0.000459, 5 - 9,FALSE
849,@puclindia,849,,1,0,1,0.002591,8,1,0,1,0,0,0,0,0.000459, 5 - 9,FALSE
850,@kkuruganti,850,,1,0,1,0.002591,8,1,0,1,0,0,0,0,0.000459, 5 - 9,FALSE
851,@manasikarthik,851,,1,0,1,0.002591,8,1,0,1,0,0,0,0,0.000459, 5 - 9,FALSE
852,@isaiahnoce,852,422,0,2,2,0,31,0,2,2,3,0.526316,0.583333,0,0.000446,Greater than 30,#FF7575
853,@habibfromstreet,853,287,0,2,2,0,31,0,2,2,3,0.526316,0.583333,0,0.000446,Greater than 30,#FF7575
854,@c_golden85,854,39,0,2,2,0,31,0,2,2,3,0.526316,0.583333,0,0.000446,Greater than 30,#FF7575
855,@unfccc,855,476382,1,1,2,0.001635,31,1,2,3,3,0.5,0.537037,0,0.000636,Greater than 30,#FF7575
856,@drozgureker,856,1156,0,12,12,0,5,0,12,12,3,0.689655,0.791667,0,0.000446, 5 - 9,FALSE
857,@risalat_k,857,,1,0,1,0.001635,5,1,0,1,0,0,0,0,0.000478, 5 - 9,FALSE
858,@vikramchandra,858,,1,0,1,0.001635,5,1,0,1,0,0,0,0,0.000478, 5 - 9,FALSE
859,@migrationpolicy,859,,1,0,1,0.001635,5,1,0,1,0,0,0,0,0.000478, 5 - 9,FALSE
860,@davos,860,,1,0,1,0.001635,5,1,0,1,0,0,0,0,0.000478, 5 - 9,FALSE
861,@unicef,861,,1,0,1,0.001635,5,1,0,1,0,0,0,0,0.000478, 5 - 9,FALSE
862,@usun,862,,1,0,1,0.001635,5,1,0,1,0,0,0,0,0.000478, 5 - 9,FALSE
863,@ukmissiongeneva,863,,1,0,1,0.001635,5,1,0,1,0,0,0,0,0.000478, 5 - 9,FALSE
864,@tdgch,864,,1,0,1,0.001635,5,1,0,1,0,0,0,0,0.000478, 5 - 9,FALSE
865,@genevaimpact,865,,1,0,1,0.001635,5,1,0,1,0,0,0,0,0.000478, 5 - 9,FALSE
866,@ungeneva,866,,1,0,1,0.001635,5,1,0,1,0,0,0,0,0.000478, 5 - 9,FALSE
867,@sachin_inc,867,12916,5,2,7,0.008177,11,5,22,27,4,0.387097,0.465278,0,0.001008,10 - 14,#75FFF7
868,@gulamhusainkha1,868,95,0,3,3,0,11,0,4,4,4,0.40625,0.50641,0,0.000446,10 - 14,#75FFF7
869,@youri_kemp,869,215,0,1,1,0,31,0,1,1,3,0.5,0.537037,0,0.000446,Greater than 30,#FF7575
870,@medios_gcb,870,336,0,5,5,0,12,0,5,5,3,0.576923,0.655556,0,0.000446,10 - 14,#75FFF7
871,@smartcitysingh,871,114,0,2,2,0,31,0,2,2,3,0.526316,0.583333,0,0.000446,Greater than 30,#FF7575
872,@csis,872,,1,0,1,0.001635,31,1,0,1,0,0,0,0,0.000636,Greater than 30,#FF7575
873,@sataetaichan,873,743,0,2,2,0,31,0,2,2,3,0.526316,0.583333,0,0.000446,Greater than 30,#FF7575
874,@abanangels,874,9261,0,2,2,0,29,0,2,2,4,0.40625,0.480769,0,0.000446,25 - 29,#FFB175
875,@ngalomba,875,726,0,1,1,0,31,0,1,1,3,0.5,0.537037,0,0.000446,Greater than 30,#FF7575
876,@boboyuru,876,53,0,2,2,0,29,0,2,2,4,0.40625,0.480769,0,0.000446,25 - 29,#FFB175
877,@blackrock,877,,1,0,1,0.003565,31,6,0,6,0,0,0,0,0.001502,Greater than 30,#FF7575
878,@robertorazeto,878,268,0,1,1,0,31,0,1,1,4,0.366667,0.416667,0,0.000446,Greater than 30,#FF7575
879,@shreenivasab,879,462,0,3,3,0,11,0,4,4,4,0.40625,0.50641,0,0.000446,10 - 14,#75FFF7
880,@mansi_amal,880,8,0,1,1,0,31,0,2,2,3,0.5,0.537037,0,0.000446,Greater than 30,#FF7575
881,@edgarbarragan11,881,246,0,1,1,0,0,0,1,1,4,0.37931,0.431818,0,0.000446,0 - 4,#FF75FF
882,@johnterrytresh,882,1350,0,2,2,0,29,0,2,2,4,0.40625,0.480769,0,0.000446,25 - 29,#FFB175
883,@bonnlab,883,1369,2,2,4,0.005989,31,2,2,4,3,0.517241,0.555556,0,0.00067,Greater than 30,#FF7575
884,@tz_akademisi,884,66,1,2,3,0.001635,31,1,8,9,3,0.526316,0.583333,0,0.000573,Greater than 30,#FF7575
885,@utikadofficial,885,,2,0,2,0.003592,31,5,0,5,0,0,0,0,0.000817,Greater than 30,#FF7575
886,@azaferacar,886,490,0,3,3,0,31,0,3,3,3,0.55,0.621212,0,0.000446,Greater than 30,#FF7575
887,@bonnfiji,887,1783,0,2,2,0,31,0,2,2,3,0.516129,0.552083,0,0.000446,Greater than 30,#FF7575
888,@pocarlee,888,1129,0,1,1,0,31,0,1,1,4,0.366667,0.416667,0,0.000446,Greater than 30,#FF7575
889,@emergingroy,889,2077,0,5,5,0,31,0,5,5,3,0.590909,0.679487,0,0.000446,Greater than 30,#FF7575
890,@joshendriks4,890,530,0,1,1,0,31,0,1,1,4,0.366667,0.416667,0,0.000446,Greater than 30,#FF7575
891,@citizensfellow,891,80,0,5,5,0,11,0,9,9,3,0.590909,0.679487,0,0.000446,10 - 14,#75FFF7
892,@omnico72,892,3219,0,2,2,0,31,0,2,2,3,0.526316,0.583333,0,0.000446,Greater than 30,#FF7575
893,@neli_ngqulana,893,7034,0,2,2,0,29,0,2,2,4,0.40625,0.480769,0,0.000446,25 - 29,#FFB175
894,@yemeni_proudly,894,523,0,4,4,0,31,0,12,12,3,0.526316,0.583333,0,0.000446,Greater than 30,#FF7575
895,@cop23bonn,895,9653,3,2,5,0.007625,31,3,2,5,3,0.517241,0.555556,0,0.000704,Greater than 30,#FF7575
896,@cometatsu,896,538,0,1,1,0,31,0,1,1,3,0.5,0.537037,0,0.000446,Greater than 30,#FF7575
897,@lydiaines8,897,431,0,3,3,0,29,0,3,3,3,0.555556,0.633333,0,0.000446,25 - 29,#FFB175
903,@capitalonenews,903,2357,0,2,2,0,29,0,2,2,4,0.40625,0.480769,0,0.000446,25 - 29,#FFB175
904,@floorithammer,904,1170,0,2,2,0,29,0,2,2,4,0.40625,0.480769,0,0.000446,25 - 29,#FFB175
905,@y7exrj0c8tlgqfo,905,20,0,2,2,0,31,0,2,2,3,0.526316,0.583333,0,0.000446,Greater than 30,#FF7575
906,@wendyr_p,906,46,0,1,1,0,31,0,1,1,4,0.363636,0.409722,0,0.000446,Greater than 30,#FF7575
907,@detoxconflict,907,1846,1,2,3,0.001635,31,1,2,3,3,0.52381,0.575758,11,0.000827,Greater than 30,#FF7575
908,@justinsandefur,908,,1,0,1,0.002591,8,1,0,1,0,0,0,0,0.000459, 5 - 9,FALSE
909,@divwadhwa,909,,1,0,1,0.002591,8,1,0,1,0,0,0,0,0.000459, 5 - 9,FALSE
910,@devinder_sharma,910,,1,0,1,0.002591,8,1,0,1,0,0,0,0,0.000459, 5 - 9,FALSE
911,@nomonsantosa,911,,1,0,1,0.002591,8,1,0,1,0,0,0,0,0.000459, 5 - 9,FALSE
912,@africalandgrabs,912,,1,0,1,0.002591,8,1,0,1,0,0,0,0,0.000459, 5 - 9,FALSE
913,@navdanyaint,913,,1,0,1,0.002591,8,1,0,1,0,0,0,0,0.000459, 5 - 9,FALSE
914,@lri_india,914,,1,0,1,0.002591,8,1,0,1,0,0,0,0,0.000459, 5 - 9,FALSE
915,@greenpoliticos,915,,1,0,1,0.002591,8,1,0,1,0,0,0,0,0.000459, 5 - 9,FALSE
916,@lydiabubniak,916,583,0,2,2,0,31,0,2,2,4,0.428571,0.486111,0,0.000446,Greater than 30,#FF7575
917,@moin2_k,917,214,0,3,3,0,11,0,4,4,4,0.40625,0.50641,0,0.000446,10 - 14,#75FFF7
918,@thecableng,918,118868,0,2,2,0,31,0,2,2,3,0.526316,0.583333,0,0.000446,Greater than 30,#FF7575
919,@bantexkd,919,,1,0,1,0.001635,31,1,0,1,0,0,0,0,0.000636,Greater than 30,#FF7575
920,@carbonandmore,920,843,0,1,1,0,31,0,1,1,4,0.366667,0.416667,0,0.000446,Greater than 30,#FF7575
921,@amicusergoest,921,1008,0,2,2,0,31,0,2,2,4,0.352113,0.416667,0,0.000446,Greater than 30,#FF7575
922,@mrahmedmohamoud,922,288,0,1,1,0,31,0,2,2,3,0.5,0.537037,0,0.000446,Greater than 30,#FF7575
923,@aklopfer_dc,923,43,0,2,2,0,31,0,2,2,3,0.526316,0.583333,0,0.000446,Greater than 30,#FF7575
924,@unatu_org,924,,1,0,1,0.006149,31,2,0,2,0,0,0,0,0.000559,Greater than 30,#FF7575
925,@gpforeducation,925,,1,0,1,0.006149,31,2,0,2,0,0,0,0,0.000559,Greater than 30,#FF7575
926,@juliagillardgpe,926,,1,0,1,0.006149,31,2,0,2,0,0,0,0,0.000559,Greater than 30,#FF7575
927,@viktorpitcoiner,927,3847,0,2,2,0,31,0,2,2,3,0.52381,0.575758,0,0.000446,Greater than 30,#FF7575
928,@sabine_hatem,928,70,1,6,7,0.001635,32,1,11,12,4,0.441176,0.572222,4,0.000573,Greater than 30,#FF7575
929,@giftmena,929,,1,0,1,0.001957,32,1,0,1,0,0,0,0,0.000527,Greater than 30,#FF7575
930,@ioflebanon,930,302,4,2,6,0.007185,32,9,8,17,3,0.526316,0.583333,20,0.000654,Greater than 30,#FF7575
931,@dgafp,931,,1,0,1,0.001957,32,1,0,1,0,0,0,0,0.000527,Greater than 30,#FF7575
932,@unescwa,932,,1,0,1,0.001957,32,1,0,1,0,0,0,0,0.000527,Greater than 30,#FF7575
933,@ena_fr,933,,1,0,1,0.001957,32,1,0,1,0,0,0,0,0.000527,Greater than 30,#FF7575
934,@negrita285,934,105,0,1,1,0,0,0,1,1,4,0.37931,0.431818,0,0.000446,0 - 4,#FF75FF
935,@equitylist,935,29300,0,3,3,0,31,0,4,4,3,0.55,0.621212,0,0.000446,Greater than 30,#FF7575
936,@snehaltaksande,936,170,0,7,7,0,11,0,8,8,3,0.590909,0.679487,0,0.000446,10 - 14,#75FFF7
937,@lamiamoubayed,937,,1,0,1,0.002985,32,4,0,4,0,0,0,0,0.000725,Greater than 30,#FF7575
938,@salimvally,938,,1,0,1,0.006149,31,2,0,2,0,0,0,0,0.000559,Greater than 30,#FF7575
939,@marcandela77,939,447,0,3,3,0,31,0,6,6,5,0.37931,0.443939,0,0.000446,Greater than 30,#FF7575
940,@prasetyoga95,940,230,0,3,3,0,31,0,3,3,3,0.55,0.621212,0,0.000446,Greater than 30,#FF7575
941,@globaldevlab,941,27111,1,3,4,0.00199,33,3,3,6,4,0.405405,0.494444,0,0.000549,Greater than 30,#FF7575
942,@rti_intl_dev,942,4824,1,5,6,0.00199,33,1,15,16,3,0.555556,0.644444,5.5,0.000602,Greater than 30,#FF7575
943,@rti_intl,943,,2,0,2,0.003981,33,4,0,4,0,0,0,0,0.000705,Greater than 30,#FF7575
944,@rockefellerfdn,944,,1,0,1,0.00199,33,3,0,3,0,0,0,0,0.000549,Greater than 30,#FF7575
945,@numintzy,945,25,0,2,2,0,31,0,2,2,3,0.526316,0.583333,0,0.000446,Greater than 30,#FF7575
946,@sacau_media,946,3354,1,1,2,0.001635,31,1,2,3,3,0.5,0.537037,0,0.000636,Greater than 30,#FF7575
947,@inaguruguru,947,2909,0,1,1,0,31,0,1,1,3,0.5,0.537037,0,0.000446,Greater than 30,#FF7575
948,@sukitnk,948,90,0,1,1,0,31,0,2,2,3,0.5,0.537037,0,0.000446,Greater than 30,#FF7575
949,@ricardort01,949,42,0,1,1,0,0,0,1,1,4,0.37931,0.431818,0,0.000446,0 - 4,#FF75FF
950,@c_jones_22,950,219,0,1,1,0,31,0,1,1,4,0.357143,0.408333,0,0.000446,Greater than 30,#FF7575
951,@gureya,951,591,0,2,2,0,31,0,2,2,3,0.526316,0.583333,0,0.000446,Greater than 30,#FF7575
952,@alvarosd77,952,385,0,8,8,0,34,0,8,8,3,0.64,0.739583,0,0.000446,Greater than 30,#FF7575
953,@jorgezambranoec,953,,1,0,1,0.001635,34,1,0,1,0,0,0,0,0.000493,Greater than 30,#FF7575
954,@municipio_manta,954,,1,0,1,0.001635,34,1,0,1,0,0,0,0,0.000493,Greater than 30,#FF7575
955,@eldiarioec,955,,1,0,1,0.001635,34,1,0,1,0,0,0,0,0.000493,Greater than 30,#FF7575
956,@eluniversocom,956,,1,0,1,0.001635,34,1,0,1,0,0,0,0,0.000493,Greater than 30,#FF7575
957,@andreselopeze,957,,1,0,1,0.001635,34,1,0,1,0,0,0,0,0.000493,Greater than 30,#FF7575
958,@tinocotania,958,,1,0,1,0.001635,34,1,0,1,0,0,0,0,0.000493,Greater than 30,#FF7575
959,@lamareaec,959,,1,0,1,0.001635,34,1,0,1,0,0,0,0,0.000493,Greater than 30,#FF7575
960,@emphconsult,960,68,0,1,1,0,31,0,2,2,3,0.5,0.537037,0,0.000446,Greater than 30,#FF7575
961,@columbiaalumnia,961,9254,0,3,3,0,0,0,3,3,3,0.458333,0.560606,0,0.000446,0 - 4,#FF75FF
962,@columbia,962,,1,0,1,0.001635,0,1,0,1,0,0,0,0,0.000573,0 - 4,#FF75FF
963,@columbiasipa,963,,1,0,1,0.001635,0,1,0,1,0,0,0,0,0.000573,0 - 4,#FF75FF
964,@agentsmith247,964,758,0,1,1,0,31,0,1,1,4,0.366667,0.416667,0,0.000446,Greater than 30,#FF7575
965,@ungei,965,28865,0,2,2,0,12,0,2,2,3,0.526316,0.583333,0,0.000446,10 - 14,#75FFF7
966,@sonnymhere,966,58,0,1,1,0,31,0,1,1,3,0.5,0.537037,0,0.000446,Greater than 30,#FF7575
967,@briancdeese,967,,1,0,1,0.16353,31,1,0,1,0,0,0,0,0.015231,Greater than 30,#FF7575
968,@fsamama,968,,1,0,1,0.16353,31,1,0,1,0,0,0,0,0.015231,Greater than 30,#FF7575
969,@aileenlee,969,,1,0,1,0.16353,31,1,0,1,0,0,0,0,0.015231,Greater than 30,#FF7575
970,@ramayatu,970,1,0,1,1,0,31,0,1,1,3,0.5,0.537037,0,0.000446,Greater than 30,#FF7575
971,@worldbanksasia,971,269690,0,1,1,0,31,0,1,1,3,0.5,0.537037,0,0.000446,Greater than 30,#FF7575
972,@alvaroespitia,972,166,0,1,1,0,31,0,1,1,3,0.5,0.537037,0,0.000446,Greater than 30,#FF7575
973,@sammyzimmo,973,82,0,2,2,0,28,0,2,2,4,0.410256,0.473958,0,0.000446,25 - 29,#FFB175
974,@karinabgonzalez,974,4615,1,6,7,0.003828,31,1,6,7,3,0.6,0.688889,0,0.000586,Greater than 30,#FF7575
975,@bhavyaenreddy,975,,2,0,2,0.005989,31,2,0,2,0,0,0,0,0.00067,Greater than 30,#FF7575
976,@fciatmsh,976,5993,0,2,2,0,31,0,2,2,3,0.526316,0.583333,0,0.000446,Greater than 30,#FF7575
977,@ms_revisionista,977,1704,1,4,5,0.00199,12,4,4,8,4,0.45283,0.524306,0,0.000475,10 - 14,#75FFF7
978,@agnahcalepulzyx,978,479,1,16,17,0.00199,12,1,64,65,3,0.727273,0.826389,20,0.000547,10 - 14,#75FFF7
979,@youtube,979,,2,0,2,0.003981,12,5,0,5,0,0,0,0,0.000576,10 - 14,#75FFF7
980,@potus,980,,2,0,2,0.003981,12,5,0,5,0,0,0,0,0.000576,10 - 14,#75FFF7
981,@alfredojalifer_,981,,1,0,1,0.00199,12,4,0,4,0,0,0,0,0.000475,10 - 14,#75FFF7
982,@ronpaul,982,,1,0,1,0.00199,12,4,0,4,0,0,0,0,0.000475,10 - 14,#75FFF7
983,@ronpaulinstitut,983,,1,0,1,0.00199,12,4,0,4,0,0,0,0,0.000475,10 - 14,#75FFF7
984,@ronpaulnews,984,,1,0,1,0.00199,12,4,0,4,0,0,0,0,0.000475,10 - 14,#75FFF7
985,@govabbott,985,,1,0,1,0.00199,12,4,0,4,0,0,0,0,0.000475,10 - 14,#75FFF7
986,@tedcruz,986,,1,0,1,0.00199,12,4,0,4,0,0,0,0,0.000475,10 - 14,#75FFF7
987,@johncornyn,987,,1,0,1,0.00199,12,4,0,4,0,0,0,0,0.000475,10 - 14,#75FFF7
988,@cfigueres,988,,1,0,1,0.00199,12,4,0,4,0,0,0,0,0.000475,10 - 14,#75FFF7
989,@boussardoli,989,230,0,1,1,0,23,0,1,1,4,0.366667,0.416667,0,0.000446,20 - 24,#E4FF75
990,@globalfindex,990,,1,0,1,0.002279,23,1,0,1,0,0,0,0,0.000853,20 - 24,#E4FF75
991,@wbg_jobs,991,7180,0,1,1,0,31,0,1,1,3,0.5,0.537037,0,0.000446,Greater than 30,#FF7575
992,@1o5cleanenergy,992,24009,0,2,2,0,5,0,2,2,4,0.387097,0.465278,0,0.000446, 5 - 9,FALSE
993,@khadkaheema,993,,1,0,1,0.001635,5,1,0,1,0,0,0,0,0.000636, 5 - 9,FALSE
994,@ayralangel,994,1142,0,2,2,0,0,0,2,2,4,0.392857,0.477273,0,0.000446,0 - 4,#FF75FF
995,@yapeka,995,18,0,1,1,0,0,0,1,1,4,0.37931,0.431818,0,0.000446,0 - 4,#FF75FF
996,@garibceo,996,1952,0,3,3,0,11,0,3,3,3,0.545455,0.611111,0,0.000446,10 - 14,#75FFF7
997,@sofia_lauritsen,997,31,0,3,3,0,31,0,3,3,3,0.55,0.621212,0,0.000446,Greater than 30,#FF7575
998,@naijcom,998,533679,1,1,2,0.001635,35,1,3,4,1,1,1,0,0.000636,Greater than 30,#FF7575
999,@bukolasaraki,999,,2,0,2,0.003592,35,4,0,4,0,0,0,0,0.00118,Greater than 30,#FF7575
1000,@nextbillion,1000,101563,0,3,3,0,0,0,3,3,3,0.458333,0.560606,0,0.000446,0 - 4,#FF75FF
1001,@verdictuk,1001,,1,0,1,0.001635,0,1,0,1,0,0,0,0,0.000573,0 - 4,#FF75FF
1002,@ficoba,1002,,1,0,1,0.001635,0,1,0,1,0,0,0,0,0.000573,0 - 4,#FF75FF
1003,@storbert,1003,43,0,3,3,0,32,0,3,3,4,0.410256,0.473958,0,0.000446,Greater than 30,#FF7575
1004,@jaimehmejia,1004,117,0,1,1,0,0,0,1,1,4,0.37931,0.431818,0,0.000446,0 - 4,#FF75FF
1005,@innocentsilver7,1005,67,0,1,1,0,31,0,1,1,3,0.5,0.537037,0,0.000446,Greater than 30,#FF7575
1006,@mabby_glory,1006,107,0,1,1,0,0,0,1,1,4,0.37931,0.431818,0,0.000446,0 - 4,#FF75FF
1007,@ctaylor_mshveep,1007,374,0,2,2,0,31,0,3,3,3,0.526316,0.583333,0,0.000446,Greater than 30,#FF7575
1008,@oviovijit,1008,450,0,1,1,0,31,0,1,1,3,0.5,0.537037,0,0.000446,Greater than 30,#FF7575
1009,@corafnews,1009,966,0,2,2,0,31,0,2,2,3,0.526316,0.583333,0,0.000446,Greater than 30,#FF7575
1010,@gatesafrica,1010,,1,0,1,0.001635,31,1,0,1,0,0,0,0,0.000636,Greater than 30,#FF7575
1011,@amchamkosovo,1011,663,0,2,2,0,31,0,2,2,3,0.526316,0.583333,0,0.000446,Greater than 30,#FF7575
1012,@ayanda16562584,1012,217,0,4,4,0,31,0,5,5,3,0.52,0.589744,0,0.000446,Greater than 30,#FF7575
1013,@mayjoynamu,1013,4116,0,5,5,0,0,0,5,5,3,0.543478,0.593333,0,0.000446,0 - 4,#FF75FF
1014,@prakash74933439,1014,12,0,3,3,0,11,0,3,3,3,0.545455,0.611111,0,0.000446,10 - 14,#75FFF7
1015,@sojiadeyi,1015,,2,0,2,0.003271,31,12,0,12,0,0,0,0,0.000509,Greater than 30,#FF7575
1016,@juliabucknall,1016,,2,0,2,0.003271,31,12,0,12,0,0,0,0,0.000509,Greater than 30,#FF7575
1017,@kbbop,1017,270,0,1,1,0,31,0,1,1,4,0.382353,0.429487,0,0.000446,Greater than 30,#FF7575
1018,@lafoundation,1018,3952,1,4,5,0.001635,31,1,4,5,3,0.571429,0.652778,12,0.000827,Greater than 30,#FF7575
1019,@landarchmag,1019,,1,0,1,0.001957,31,1,0,1,0,0,0,0,0.000622,Greater than 30,#FF7575
1020,@simbizhanje,1020,324,0,11,11,0,31,0,11,11,3,0.631579,0.722222,0,0.000446,Greater than 30,#FF7575
1021,@lisaelges,1021,,1,0,1,0.001635,31,1,0,1,0,0,0,0,0.00048,Greater than 30,#FF7575
1022,@jpbrice,1022,,1,0,1,0.001635,31,1,0,1,0,0,0,0,0.00048,Greater than 30,#FF7575
1023,@fissehatessema,1023,,1,0,1,0.001635,31,1,0,1,0,0,0,0,0.00048,Greater than 30,#FF7575
1024,@maevemclynn,1024,,1,0,1,0.001635,31,1,0,1,0,0,0,0,0.00048,Greater than 30,#FF7575
1025,@adaptationfund,1025,,1,0,1,0.001635,31,1,0,1,0,0,0,0,0.00048,Greater than 30,#FF7575
1026,@sa214h,1026,587,0,8,8,0,36,0,8,8,3,0.64,0.739583,0,0.000446,Greater than 30,#FF7575
1027,@rbi,1027,,1,0,1,0.001635,36,1,0,1,0,0,0,0,0.000493,Greater than 30,#FF7575
1028,@ummeedewafa,1028,,1,0,1,0.001635,36,1,0,1,0,0,0,0,0.000493,Greater than 30,#FF7575
1029,@sitaramyechury,1029,,1,0,1,0.001635,36,1,0,1,0,0,0,0,0.000493,Greater than 30,#FF7575
1030,@anusha_puppala,1030,,1,0,1,0.001635,36,1,0,1,0,0,0,0,0.000493,Greater than 30,#FF7575
1031,@theofficialsbi,1031,,1,0,1,0.001635,36,1,0,1,0,0,0,0,0.000493,Greater than 30,#FF7575
1032,@ap,1032,,1,0,1,0.001635,36,1,0,1,0,0,0,0,0.000493,Greater than 30,#FF7575
1033,@silsde,1033,74,0,2,2,0,0,0,2,2,4,0.342857,0.4375,0,0.000446,0 - 4,#FF75FF
1034,@pri_news,1034,12839,0,2,2,0,0,0,2,2,3,0.434783,0.516667,0,0.000446,0 - 4,#FF75FF
1035,@empea,1035,,1,0,1,0.001635,0,1,0,1,0,0,0,0,0.000636,0 - 4,#FF75FF
1036,@elsakekita,1036,5176,0,1,1,0,0,0,1,1,4,0.37931,0.431818,0,0.000446,0 - 4,#FF75FF
1037,@chosensomto,1037,4002,1,5,6,0.003001,28,1,25,26,3,0.576923,0.655556,0,0.000524,25 - 29,#FFB175
1038,@henrymalumo,1038,1388,0,9,9,0,0,0,9,9,3,0.583333,0.654762,0,0.000446,0 - 4,#FF75FF
1039,@globaleducation,1039,,1,0,1,0.001635,0,1,0,1,0,0,0,0,0.000488,0 - 4,#FF75FF
1040,@nigeria_ass,1040,304,1,5,6,0.003001,28,1,25,26,3,0.576923,0.655556,0,0.000524,25 - 29,#FFB175
1041,@rajanmahisaniya,1041,228,0,2,2,0,31,0,2,2,3,0.526316,0.583333,0,0.000446,Greater than 30,#FF7575
1042,@craymondrobin,1042,429,0,3,3,0,11,0,4,4,4,0.40625,0.50641,0,0.000446,10 - 14,#75FFF7
1043,@monsodana,1043,206,0,3,3,0,31,0,3,3,3,0.55,0.621212,0,0.000446,Greater than 30,#FF7575
1044,@oienelmio,1044,1552,0,4,4,0,0,0,4,4,3,0.571429,0.652778,0,0.000446,0 - 4,#FF75FF
1045,@aliciabelfig,1045,,1,0,1,0.001635,0,1,0,1,0,0,0,0,0.000541,0 - 4,#FF75FF
1046,@ebunolayomi,1046,2347,0,2,2,0,35,0,2,2,1,1,1,0,0.000446,Greater than 30,#FF7575
1047,@jill_xt,1047,95,0,1,1,0,31,0,1,1,3,0.5,0.537037,0,0.000446,Greater than 30,#FF7575
1048,@napilly,1048,73,0,6,6,0,31,0,7,7,3,0.608696,0.702381,0,0.000446,Greater than 30,#FF7575
1049,@grassrootsintl,1049,,1,0,1,0.003962,8,1,0,1,0,0,0,0,0.000471, 5 - 9,FALSE
1050,@vishalgreat,1050,535,0,6,6,0,31,0,10,10,4,0.454545,0.605556,0,0.000446,Greater than 30,#FF7575
1051,@rahulgandhi,1051,,1,0,1,0.001635,31,1,0,1,0,0,0,0,0.000509,Greater than 30,#FF7575
1052,@akbaruddinindia,1052,,1,0,1,0.001635,31,1,0,1,0,0,0,0,0.000509,Greater than 30,#FF7575
1053,@amitabhk87,1053,,1,0,1,0.001635,31,1,0,1,0,0,0,0,0.000509,Greater than 30,#FF7575
1054,@vikasswarup,1054,,1,0,1,0.001635,31,1,0,1,0,0,0,0,0.000509,Greater than 30,#FF7575
1055,@meaindia,1055,,1,0,1,0.001635,31,1,0,1,0,0,0,0,0.000509,Greater than 30,#FF7575